Ke^Ecf, Ke^Ecf, Ke^Ecf, Ke^Ecf, Ke^Ecf, Ke^Ecf, Ke^Ecf, Ke^Ecf, Ke^Ecf, Ke^Ecf, Ke^Ecf, Ke^Ecf, Ke^Ecf, Ke^Ecf, Ke^Ecf, Ke^Ecf, Ke^Ecf, Ke^Ecf, Ke^Ecf, Ke^Ecf, Ke^Ecf, Ke^Ecf
Ket^Xo, Ket^Xo, Ket^Xo, Ket^Xo, Ket^Xo, Ket^Xo, Ket^Xo, Ket^Xo, Ket^Xo, Ket^Xo, Ket^Xo, Ket^Xo, Ket^Xo, Ket^Xo, Ket^Xo, Ket^Xo, Chw^Xo, Chw^Xo, Chw^Xo, Chw^Xo, Chw^Xo, Ket^Xo
Qxua, Qxua, Qxua^Bw|, Qxua, Qxua^Bw|, Qxua, Qxua^Bw|, Qxua, Qxua^Bw|, Qxua, Qxua^Bw|, Qxua, Qxua, Qxua, Qxua, Qxua, Qxua, Wo, Wo^Bsb|, Wo, Qxua, Qxua
Qxua, Qxua, Gg, Qxua, Gg, Qxua, Gg, Qxua, Gg, Qxua, Gg, Qxua, Wo, Wo, Wo, Wo, Wo, Qxua, Gg, Wo, Wo, Qxua
Qxua, Qxua, Qxua, Gg, Qxua, Qxua, Qxua, Gg, Qxua, Qxua, Gg, Qxua, Wo^Bw/, Gg, Ww, Gg, Wo, Gg, Gg, Gg, Wo, Qxua
Qxua, Gs^Fms, Qxua^Bsb\, Qxua^Bw|, Qxua^Bsb/, Hh, Qxua, Qxua^Bw|, Qxua, Gg, Ww, Qxua, Wo^Bw|, Qxua, Ww, Qxua, Qxua^Bcx/, Wo^Bcx/, Wo, Wo, Qxua, Qxua
Qxua, Gs^Fms, Qxua, Gg, Qxua, Hh, Qxua, Gg, Qxua, Ww, Gg, Qxua, Wo^Bw|, Qxua, Wwf, Qxua^Bcx/, Qxua, Ww, Ww, Ww, Qxua, Qxua
Qxua, Qxua^Bw|, Qxua, Gg, Qxua, Qxua^Bw|, Qxua, Uu^Vm, Qxua, Gg^Ebn, Qxua, Qxua, Wo^Bw|, Qxua, Wo, Qxua, Gg, Ww, Gg^Vd, Ww, Gg, Qxua
Qxua, Gg, Qxua, Gg, Qxua, Gg, Qxua, Gg, Qxua^Bh\, Qxua, Ket, Ket, Wo^Bw|, Qxua, Ww^Eb, Qxua, Gg, Qxua, Qxua^Bp|, Qxua, Gg, Qxua
Qxua, Gg, Qxua, Gg, Qxua, Gg, Qxua, Qxua, Gg, Gg, Wo, Wo, Gg, Qxua, Qxua, Qxua, Qxua^Bcx|, Qxua^Bp\, Aa^Vm, Qxua^Bp/, Qxua^Bcx|, Qxua
Ww, Gg, Ww, Ww^Bp|, Ww, Gg, Ww, Ww, Wo, Wo^Bp|, Ket, Ket, Wo^Bp|, Gg, Ww, Qxua, Ww^Bcx|, Qxua, Qxua^Bp|, Qxua, Ww^Bcx|, Qxua
Ww, Gg, Ww, Gg, Ww, Gg, Ww, Wwf, Wo, Ql^Bp|, Wo, Wo, Ql^Bp|, Wo, Wwf, Ww, Gg, Ww, Gg, Ww, Gg, Ww
Qxua, Ww^Bcx|, Qxua, Qxua^Bp|, Qxua, Ww^Bcx|, Qxua, Ww, Gg, Wo^Bp|, Ket, Ket, Wo^Bp|, Wo, Ww, Ww, Gg, Ww, Ww^Bp|, Ww, Gg, Ww
Qxua, Qxua^Bcx|, Qxua^Bp/, Dd^Vm, Qxua^Bp\, Qxua^Bcx|, Qxua, Qxua, Qxua, Gg, Wo, Wo, Gg, Gg, Qxua, Qxua, Gg, Qxua, Gg, Qxua, Gg, Qxua
Qxua, Gg, Qxua, Qxua^Bp|, Qxua, Gg, Qxua, Ww, Qxua, Wo^Bw|, Ket, Ket, Qxua, Qxua^Bh\, Gg, Qxua, Gg, Qxua, Gg, Qxua, Gg, Qxua
Qxua, Gg, Ww, Gg^Vd, Ww, Gg, Qxua, Wo, Qxua, Wo^Bw|, Qxua, Qxua, Gg^Ebn, Qxua, Ss^Vm, Qxua, Qxua^Bw|, Qxua, Gg, Qxua, Qxua^Bw|, Qxua
Qxua, Qxua, Ww, Ww, Ww, Qxua, Qxua^Bcx/, Wwf, Qxua, Wo^Bw|, Qxua, Gg, Ww, Qxua, Gg, Qxua, Gs^Fms, Qxua, Gg, Qxua, Hh, Qxua
Qxua, Qxua, Wo, Wo, Wo^Bcx/, Qxua^Bcx/, Qxua, Ww, Qxua, Wo^Bw|, Qxua, Ww, Gg, Qxua, Qxua^Bw|, Qxua, Gs^Fms, Qxua^Bsb/, Qxua^Bw|, Qxua^Bsb\, Hh, Qxua
Qxua, Wo, Gg, Gg, Gg, Wo, Gg, Ww, Gg, Wo^Bw/, Qxua, Gg, Qxua, Qxua, Gg, Qxua, Qxua, Qxua, Gg, Qxua, Qxua, Qxua
Qxua, Wo, Wo, Gg, Qxua, Wo, Wo, Wo, Wo, Wo, Qxua, Gg, Qxua, Gg, Qxua, Gg, Qxua, Gg, Qxua, Gg, Qxua, Qxua
Qxua, Qxua, Qxua, Wo^Bsb|, Wo, Qxua, Qxua, Qxua, Qxua, Qxua, Qxua, Qxua^Bw|, Qxua, Qxua^Bw|, Qxua, Qxua^Bw|, Qxua, Qxua^Bw|, Qxua, Qxua^Bw|, Qxua, Qxua
Xos^Xo, Xos^Xo, Khw^Xo, Chw^Xo, Chw^Xo, Chw^Xo, Khw^Xo, Iwr^Xo, Iwr^Xo, Iwr^Xo, Iwr^Xo, Iwr^Xo, Iwr^Xo, Iwr^Xo, Iwr^Xo, Iwr^Xo, Iwr^Xo, Iwr^Xo, Iwr^Xo, Iwr^Xo, Xos^Xo, Xos^Xo
Wog, Wog, Wog, Wog, Wwg, Wwg, Aa, Aa, Aa, Aa, Aa, Aa, Aa, Rb, Aa, Rb, Rb, Aa, Aa, Rb, Aa, Aa
Wog, Wog, Wog, Wog, Wwg, Wwg, Wwg, Aa, Aa, Aa, Wwg, Aa, Aa, Aa, Aa, Aa, Aa, Aa, Aa, Rb, Aa, Aa
Wog, Wog, Wwg, Wwg, Wwg, Wwg, Wog, Wog, Wog, Wog, Wog, Aa, Aa, Aa, Wwg, Aa, Rb, Rb, Aa^Vct, Aa, Aa, Wwg
Wwg, Wwg, Wwg, Wwg, Wwg, Wwg, Wog, Wog, Wog, Wog, Wog, Wog, Wog, Wog, Wog, Aa, Rb, Aa, Aa, Aa, Wwg, Wwg
Wwg, Wwg, Ha, Wwg, Wog, Wog, Wog, Wog, Wwg, Wog, Wog, Wog, Wog^Vm, Wog, Wog, Aa, Wwg, Aa, Wwg, Wwg, Wwg, Wwg
Wwg, Wwg, Ms, Wog, Wog, Wog, Wwg, Ms, Ha^Fpa, Ms, Wog, Wog, Wog, Wog, Wog, Wog, Wog, Wwg, Wwg, Wwg, Wwg, Wog
Wwg, Aa, Aa, Wog, Wog, Wog, Wog, Wwg, Wog, Wog, Wog, Wog, Ha^Fpa, Wog, Wog, Wog, Wog, Wog, Wog, Wog, Wog, Wog
Aa^Fpa, Aa^Vha, Aa^Fpa, Wwg, Wog, Wog, Wog, Wog, Wog, Wog, Wwg, Wwg, Ha^Fpa, Aa^Fpa, Aa^Fpa, Wog, Wog, Wog, Wwg, Wog, Wog, Wog
Wwg, Aa^Fpa, Wwg, Wog, Wog, Wog, Wog, Wog, Aa, Aa^Vhca, Wwg, Wwg, Wwg, Ha^Fpa, Ha, Aa, Wog, Wog, Wog, Wog, Wog, Wog
Wwg, Wwg, Wwg, Wog, Wog, Wog^Vm, Wog, Aa, Aa^Fpa, Aa^Fpa, Aa^Fpa, Wwg, Ms, Ms, Ha, Aa, Wog, Wog, Wog, Wog^Vm, Wog, Wog
Aa^Fp, Aa^Fp, Aa^Fp, Wog, Wog, Wog, Wwg, Aa, Aa^Fpa, Aa^Fpa, Aa^Fpa, Ms^Fpa, Ms^Xm, Ms^Xm, Wwg, Wwg, Aa^Fpa, Wwg, Wwg, Wog, Wog, Wog
Aa^Fp, Aa^Fp, Ss, Aa^Fp, Wwg, Wwg, Wwg, Wog, Wog, Wwg, Aa^Fpa, Aa^Fpa, Wwg, Wwg, Wog, Wog, Aa^Fpa, Aa^Fpa, Aa^Fpa, Wog, Wog, Wog
Ss, Ss, Ss, Wwg, Wwg, Wwg, Wwg, Wog, Wog, Wog, Wog, Wwg, Wog, Wog, Wog, Wog, Wwg, Aa^Fpa, Aa^Fpa, Wog, Wwg, Wwg
Ss, Ss, Wwg, Wwg, Wog, Wog, Wog, Wog, Aa, Wog, Wog, Wog, Wog, Wog, Wog, Wog, Wog, Wwg, Wog, Wwg, Aa^Fpa, Aa^Fpa
Aa, Aa, Rb, Aa, Aa, Wog, Wog, Aa, Aa, Aa, Aa, Wwg, Wwg, Wwg, Wog, Wog^Vm, Wog, Wog, Wog, Wog, Aa^Fpa, Aa^Fpa
Aa, Rb^Vca, Rb, Aa, Wwg, Wog, Wog, Wwg, Aa, Rb, Rb, Ha, Ha, Wwg, Wwg, Wog, Wog, Wog, Wwg, Aa^Fpa, Aa^Fpa, Aa^Fpa
Aa, Rb, Aa, Aa, Wwg, Wog, Wog, Wwg, Aa^Fpa, Aa, Aa, Ha, Aa^Voa, Aa, Wwg, Wog, Wwg, Wog, Wwg, Aa^Fpa, Aa^Fpa, Aa^Fpa
Aa, Rb, Aa, Wwg, Wog, Wog, Wog, Wwg, Wwg, Aa^Fpa, Rb, Aa, Aa, Aa, Wwg, Wwg, Wwg, Wwg, Aa^Fpa, Aa^Vla, Aa^Fpa, Aa^Fpa
Cha, Cha, Cha, Wwg, Wog, Wog, Wog, Wwg, Wwg, Aa, Aa, Rb, Aa, Wwg, Wwg, Wwg, Wwg, Wwg, Aa^Fpa, Aa^Fpa, Aa^Fpa, Aa^Fpa
Cha^Xo, Cha^Xo, Cha^Xo, Khw^Xo, Chw^Xo, Chw^Xo, Chw^Xo, Chw^Xo, Khw^Xo, Cha^Xo, Cha^Xo, Cha^Xo, Cha^Xo, Khw^Xo, Chw^Xo, Chw^Xo, Chw^Xo, Chw^Xo, Khw^Xo, Cha^Xo, Cha^Xo, Cha^Xo
Xu, Cha, Cha, Wwg, Wwg, Wog, Wog, Wwg, Wwf, Ur, Ur, Uu, Uu^Dr, Wwg, Wog, Wog, Wwg^Ii, Wwg, Uu^Ii, Ur, Uu, Qxu
Xu, Uu^Br|, Uu^Br\, Uu^Vu, Uu, Wwg, Wwg, Wwg, Uh, Uu, Uu, Uu^Dr, Uu^Dr, Wwf, Wwg, Wwg^Ii, Uu^Ii, Uu^Ii, Ur^Ii, Ur^Ii, Uu, Xu
Qxu, Uh, Uu, Uu^Br\, Uu^Uf, Uu^Uf, Uu^Uf, Wog, Wwg, Uu, Uu^Vu, Uu, Wwf, Wog, Uu^Uf, Uu^Ufi, Uu^Ii, Uu^Ii, Ur^Ii, Uh^Vu, Uu, Xu
Qxu, Uh, Uu^Br/, Uu^Br|, Xu, Uu^Uf, Uu, Wwf, Wwg, Uu, Wog, Wwg, Wwg, Wog, Uu^Vu, Uu^Uf, Uu, Ur^Ii, Uu, Uu, Xu, Xu
Uh, Uh, Uu^Br|, Uh, Uu^Br/, Uu^Br/, Uu^Br\, Uu, Wog, Wwg, Wwg, Wwg, Wwg, Uh, Uh, Uh, Uh, Uh, Uh, Uu, Qlf, Qlf
Uh, Qxu, Uu, Uu^Br\, Cud, Uu, Uu, Uu^Br\, Uu^Br\, Wwg, Wwg^Br/, Ur^Br/, Wwg^Br\, Uh, Uh, Uh, Uh, Ur, Qlf, Qlf, Xu, Qlf
Xuc, Xuc, Uu, Uu, Uu^Vud, Xuc, Cud, Uu, Uu, Uu^Br\, Wwt, Wwg, Wwt, Uu^Br\, Uu^Br\, Uu, Uu, Uu, Qlf^Bs\, Qlf, Qlf, Xu
Xuc, Uu, Cud, Uu, Uu, Uu, Uu, Xuc, Uh, Uu, Uh, Uh, Uh, Uh, Uh, Uu^Br\, Qlf, Qlf, Ql, Qlf^Bs\, Ur, Qlf
Xu, Uu, Uu, Xuc, Uu, Uu, Uu, Uh, Qlf, Qlf, Wwt^Bw/, Uh, Qlf, Qlf, Qlf, Qlf^Br|, Qlf, Qlf, Ql, Ql, Ql^Bp|, Ql
Xu, Uu, Uh, Uu, Uu, Uu, Qlf, Qlf, Qlf^Bw/r, Wwt^Bw/, Qlf, Wwt, Qlf, Ww^Vm, Qlf, Qlf^Br|, Qxu, Ql, Qxu, Ql, Ur, Qxu
Qlf, Qlf, Qlf^Bcx/, Uu, Qlf, Uh, Qlf, Uu, Uh, Wwt, Wwt, Wwf, Qlf, Qlf, Uue, Uue^Br|, Xue, Qxu, Qxe^Bh/, Ql^Bh/, Qxu, Qxu
Qlf, Uu, Qlf, Qlf, Uh, Qlf^Bs|, Qlf, Uu, Uh, Uh, Uh, Qlf, Xuc, Uh, Uu, Uue^Br|, Xue, Uue, Qxe, Qxe, Qxu, Ql
Qlf, Qlf^Bcx|, Qlf, Qlf, Uh, Uu, Uu^Uf, Ur, Ur, Uh, Wwg, Wwg, Wwg, Uu^Br\, Uu^Br\, Ur^Br|, Xue, Uue, Uue, Qxe, Qxe, Qxu
Qlf, Uu, Ur, Uh, Uu^Vu, Uu^Uf, Uu^Uf, Uu^Uf, Ur, Wog, Ur, Wwg^Bsb/, Wwg, Xuc, Uu, Ur^Br|, Uue, Xue, Xue, Uue, Uue^Vud, Qxu
Xue, Uue, Uu, Ur, Ur^Uf, Uu^Uf, Uu^Uf, Uu^Uf, Uu, Uu, Wwg, Wog, Wwg, Xuc, Uh, Ur^Br|, Uu, Uue, Xue, Uue, Uu, Qxu^Bh/
Xue, Uue^Uf, Uue^Uf, Uu^Uf, Uu^Uf, Uu, Ur, Uu, Uu^Br/, Uu^Br/, Wwg^Br\, Wog, Wwg, Xuc, Uh, Uu^Br|, Uu, Uu^Vud, Xos, Ur, Uu, Qxu
Qxe, Uue^Uf, Uu^Uf, Uu^Uf, Uu^Uf, Uu^Uf, Uu^Br/, Uu^Br/, Uu, Uu, Wwg, Uu^Br\, Wwg^Br\, Uu, Uu, Uu^Br|, Uu, Uu^Uf, Xos, Uu, Ur, Qxu
Qxe, Uue^Uf, Uu, Uu^Uf, Uu^Br/, Uu^Br/, Qxu^Bp\, Qxu, Qxu, Wwg, Uu^Vu, Uu, Wwg, Uu^Br\, Ur^Br/, Ur^Br\, Xos, Xos, Uu, Uu, Ur, Qxu
Xue, Uue, Uu^Br|, Uu^Br/, Uu, Qxu, Qxu, Uu, Uu, Wwg, Wog, Wog, Wwg, Xos, Xos, Xos, Uu, Uu, Ur, Ur, Uu, Qxu
Cud^Xo, Cud^Xo, Cud^Xo, Cud^Xo, Cud^Xo, Cud^Xo, Cud^Xo, Cud^Xo, Cud^Xo, Khw^Xo, Chw^Xo, Chw^Xo, Khw^Xo, Cud^Xo, Cud^Xo, Cud^Xo, Cud^Xo, Cud^Xo, Cud^Xo, Cud^Xo, Cud^Xo, Cud^Xo
Mdd, Dd, Dd, Dd, Dd, Rd, Dd, Dd, Ds, Wwt, Wot, Wot, Wwt, Ds, Dd^Edp, Rd^Edp, Rd^Edp, Dd^Edp, Dd^Edp, Rd^Edp, Rd^Edp, Dd
Dd, Dd, Rd, Rd, Dd, Dd, Dd, Dd, Ds, Wwt, Wwt, Wwt, Wwf^Vht, Ds, Rd^Edp, Dd^Edp, Rd^Edp, Dd^Edp, Dd^Edp, Dd^Edp, Rd^Edp, Dd^Edp
Hd, Hd, Hd, Dd, Hd, Dd, Rd, Dd, Dd, Ds, Rd, Wwf, Rd, Dd, Dd, Dd^Edp, Rd^Edp, Dd^Edp, Dd^Edp, Dd^Edp, Dd^Edp, Dd
Mdd^Xm, Mdd, Hd, Hd, Mdd, Hd, Hd, Hd, Hd, Hd, Rd, Wwf, Wwf, Rd, Dd, Dd^Edp, Dd^Edp, Rd^Edp, Rd^Edp, Rd^Edp, Dd^Edp, Dd
Mdd^Xm, Mdd, Hd, Mdd^Vhh, Mdd^Xm, Mdd, Mdd, Mdd, Hd, Dd, Dd, Rd, Wwf, Rd, Rd, Dd, Dd^Edp, Dd^Edp, Rd^Edp, Dd^Vda, Dd^Edp, Dd
Mdd, Mdd, Hd, Mdd, Hd, Mdd, Hd, Hd, Dd^Vdt, Dd, Rd, Ds, Wwf, Ds, Dd, Dd, Rd, Dd^Edp, Dd^Edp, Dd^Edp, Rd, Dd
Hd, Hd, Hd, Hd, Hd, Hd, Hd, Dd^Dc, Dd, Dd, Rd, Rd, Rd, Rd, Dd, Dd, Rd^Esd, Dd^Edp, Dd^Edp, Dd^Edp, Dd^Edp, Rd
Hd, Hd, Hd, Hd, Hd, Hd, Hd, Dd, Dd, Rd, Wwf, Wwf, Rd, Re^Vct, Rd, Dd, Dd, Rd^Esd, Rd^Edp, Dd^Edp, Dd^Edp, Rd
Hd, Hd, Hd, Hd, Hd, Hd, Rd, Rd, Dd, Rd, Wwf, Rd, Rd, Dd^Esd, Rd^Esd, Dd^Esd, Dd, Dd^Esd, Dd^Edp, Dd^Edp, Dd^Edp, Rd
Hd, Hd, Hd, Hd, Hd, Dd, Dd, Dd, Ds^Ftd, Ds^Ftd, Wwt, Rd, Wwt, Ds, Ds, Dd^Esd, Dd, Dd, Dd, Dd^Edp, Dd, Rd
Hd, Hd, Hd, Hd, Hd, Dd, Dd, Rd^Vc, Wwt, Wwt, Wwrt, Wwt, Wwt, Wwt, Wwt, Rd, Rd, Cdr, Dd^Esd, Dd^Esd, Rd^Esd, Dd
Hd, Hd, Hd, Hd, Rd, Rd, Dd, Rd^Ftd, Wwt, Wwrt, Wot, Wwt, Wot, Wwt, Wwt, Wwf, Rd, Dd^Esd, Dd^Vdr, Dd^Dr, Dd^Esd, Dd
Hd, Hd, Dd, Dd, Dd, Dd, Dd, Ds^Ftd, Wwt, Wwt, Wot, Wot, Wot, Wwt, Wwt, Wwt, Rd, Dd^Esd, Dd^Dr, Kdr, Dd^Esd, Dd
Dd, Hd^Vhr, Dd, Rd, Dd, Dd, Rd, Ds^Ftd, Wwt, Wot, Wot, Wot, Wot, Wwrt, Wwt, Wwt, Ds, Dd^Esd, Rd^Esd, Dd^Dr, Cdr, Dd
Dd, Dd, Gd^Fts, Rd, Dd, Dd, Rd^Ftd, Ds^Ftd, Wwt, Wwrt, Wot, Wot, Wot, Wwrt, Wwt, Wwt, Ds, Cdr, Cdr, Rd^Esd, Dd, Dd
Dd, Gd^Fts, Gd^Do, Gd^Fts, Dd, Dd, Rd^Ftd, Wwt, Ww^Vm, Wwrt, Wwrt, Wot, Wot, Ww^Vm, Rd, Ds, Dd^Esd, Dd, Dd, Rd, Dd^Esd, Dd
Dd, Gd^Fts, Gd^Fts, Gd^Fts, Dd, Dd, Ds^Ftd, Wwt, Wwt, Wwt, Wwt, Wot, Wwt, Wwt, Ds, Dd^Esd, Rd^Esd, Dd, Dd, Dd, Dd^Esd, Dd
Dd, Dd, Dd, Rd, Dd, Dd, Dd, Rd^Ftd, Rd, Wwt, Wot, Wot, Wwt, Rd, Dd, Rd, Dd, Dd, Rd, Rd, Dd, Dd
Dd, Dd, Dd, Rd, Dd, Dd, Dd, Dd, Ds, Wwt, Wot, Wot, Wwt, Ds, Dd, Dd, Dd, Dd, Rd, Dd, Dd, Dd
Cd^Xo, Cd^Xo, Cd^Xo, Cd^Xo, Cd^Xo, Cd^Xo, Cd^Xo, Cd^Xo, Cd^Xo, Khw^Xo, Chw^Xo, Chw^Xo, Khw^Xo, Cd^Xo, Cd^Xo, Cd^Xo, Cd^Xo, Cd^Xo, Cd^Xo, Cd^Xo, Cd^Xo, Cd^Xo
Mm^Xm, Mm, Hh, Gg, Gg^Fp, Hh^Fp, Hh^Fp, Hh, Gg, Ww, Wo, Wo, Ww, Gg, Hh, Hh, Hh, Hh, Hh, Hh, Mm, Mm^Xm
Mdd^Xm, Mdd, Hd, Hh^Fp, Hh^Fp, Gg, Hh^Fp, Hh, Gg, Ww, Wo, Ww, Hh, Gg, Gg, Hh, Hh, Hh, Hh, Hh, Mm, Mm^Xm
Mdd^Xm, Mdd, Hd, Hh^Fp, Hh^Vo, Gg^Fp, Hh^Fp, Hh, Hh, Ww, Wo, Wwf, Hh, Mm, Gg, Gs^Vh, Mm, Mm^Xm, Mm, Hh, Mm, Mm^Xm
Mdd^Xm, Mdd, Hd, Hh^Fp, Hh^Fp, Gg^Fp, Hh^Fp, Hh, Gg, Ww, Gg, Ww, Ww, Gg, Mm, Hh, Ww, Wwf, Ww, Hh, Mm, Mm^Xm
Mdd^Xm, Mdd, Hd, Hh^Fp, Hh^Fp, Gg, Hh^Fp, Hh, Gg, Ww^Bsb/, Ww, Gg, Ww^Bsb\, Gg, Hh, Gg, Ww, Wo, Ww, Hh, Mm, Mm^Xm
Mdd^Xm, Mdd, Hd, Hh, Hh, Gg^Fp, Gg, Gg, Mm, Hh, Wwf^Vht, Wo, Ww, Gg, Mm, Gg, Ww, Wo^Vm, Ww, Hh, Mm, Mm^Xm
Mdd^Xm, Mdd, Hd, Hh, Hh, Gg, Hh, Hh, Gg, Gg, Ww^Bw\, Wo, Ww, Gg, Hh, Gg, Ww, Wo, Ww, Hh, Mm, Mm^Xm
Mdd^Xm, Mdd, Hd, Hh, Hh, Gg, Mm, Mm, Gg, Ww, Wo, Wo^Bw\, Ww^Bw\, Hh, Mm, Hh, Mm, Ww, Wwf, Hh, Mm, Mm^Xm
Mm^Xm, Mdd, Hd, Hh, Hh, Gg, Gg, Gg, Ww, Ww, Wo, Ww, Ww^Bsb/, Gg, Hh, Mm, Ww, Wwf, Hh, Hh, Mm, Mm^Xm
Mm^Xm, Md, Hhd, Hh^Vhh, Hh, Mm, Ww, Wwf, Ww, Ww, Wo^Bsb/, Wo^Bsb/, Ww, Ww, Wwf, Ww, Mm, Hh, Hh^Vhh, Hh, Mm, Mm^Xm
Mm^Xm, Md, Hh, Hh, Wwf, Ww, Mm, Hh, Gg, Ww^Bsb/, Ww, Wo, Ww, Ww, Gg, Gg, Gg, Hh, Hh, Ha, Ms, Mm^Xm
Mm^Xm, Mm, Hh, Wwf, Ww, Mm, Hh, Mm, Hh, Ww^Bw\, Wo^Bw\, Wo, Ww, Gg, Mm, Mm, Gg, Hh, Hh, Ha, Ms, Ms^Xm
Mm^Xm, Mm, Hh, Ww, Wo, Ww, Gg, Hh, Gg, Ww, Wo, Ww^Bw\, Gg, Gg, Hh, Hh, Gg, Hh, Hh, Ha, Ms, Ms^Xm
Mm^Xm, Mm, Hh, Ww, Wo^Vm, Ww, Gg, Mm, Gg, Ww, Wo, Wwf^Vht, Hh, Mm, Gg, Gg, Gg^Fp, Hh, Hh, Ha, Ms, Ms^Xm
Mm^Xm, Mm, Hh, Ww, Wo, Ww, Gg, Hh, Gg, Ww^Bsb\, Gg, Ww, Ww^Bsb/, Gg, Hh, Hh^Fp, Gg, Hh^Fp, Hh^Fp, Ha, Ms, Ms^Xm
Mm^Xm, Mm, Hh, Ww, Wwf, Ww, Hh, Mm, Gg, Ww, Ww, Gg, Ww, Gg, Hh, Hh^Fp, Gg^Fp, Hh^Fp, Hh^Fp, Ha, Ms, Ms^Xm
Mm^Xm, Mm, Hh, Mm, Mm^Xm, Mm, Gs^Vh, Gg, Mm, Hh, Wwf, Wo, Ww, Hh, Hh, Hh^Fp, Gg^Fp, Hh^Vo, Hh^Fp, Ha, Ms, Ms^Xm
Mm^Xm, Mm, Hh, Hh, Hh, Hh, Hh, Gg, Gg, Hh, Ww, Wo, Ww, Gg, Hh, Hh^Fp, Gg, Hh^Fp, Hh^Fp, Ha, Ms, Ms^Xm
Mm^Xm, Mm, Hh, Hh, Hh, Hh, Hh, Hh, Gg, Ww, Wo, Wo, Ww, Gg, Hh, Hh^Fp, Hh^Fp, Gg^Fp, Gg, Hh, Mm, Mm^Xm
Co^Xo, Co^Xo, Co^Xo, Co^Xo, Co^Xo, Co^Xo, Co^Xo, Co^Xo, Co^Xo, Khw^Xo, Chw^Xo, Chw^Xo, Khw^Xo, Co^Xo, Co^Xo, Co^Xo, Co^Xo, Co^Xo, Co^Xo, Co^Xo, Co^Xo, Co^Xo
Gll^Ftr, Gll^Ftr, Gll^Ftr, Gll^Ftr, Gll^Ftr, Gll^Ftr, Gll^Ftr, Gll^Ftr, Ss^Efm, Ss, Wog, Wog, Ss, Ss, Sm, Sm, Sm, Sm^Bw|, Sm, Sm, Sm, Sm
Gll^Ftr, Gll^Ftr, Gll^Ftr, Gll^Ftr, Gs^Vht, Gll^Ftr, Gll^Ftr, Gll^Ftr, Ss^Efm, Ss^Efm, Ss, Ss, Ss, Ss, Sm, Sm, Mm, Re, Sm^Vhs, Sm^Edb, Sm^Edb, Sm
Gll^Ftr, Gll^Ftr, Gll^Ftr, Gll^Ftr, Gll^Ftr, Gll^Ftr, Gll^Ftr, Gll^Ftr, Wwf^Ftr, Ss^Ftr, Sm^Ftr, Ss^Ftr, Ss, Ss, Wog^Bw/r, Rb, Sm, Rb, Sm, Sm, Sm^Edb, Sm
Sm, Gll^Ftr, Gll^Ftr, Gll^Ftr, Gll^Ftr, Gll^Ftr, Sm^Ftr, Wwf^Ftr, Ss^Efm, Wog^Ftr, Ss^Ftr, Ss^Ftr, Rb, Ss, Sm, Sm, Rb, Sm, Rb, Sm, Sm^Edb, Sm
Sm, Sm, Sm, Gll^Ftr, Gll^Ftr, Gll^Ftr, Sm^Ftr, Sm^Vhs, Ss^Efm, Ss^Ftr, Ss, Ss^Ftr, Ss^Ewf, Ss^Ewf, Ss^Ewf, Sm, Re, Sm, Sm, Rb, Hh, Sm
Sm, Gll^Ftr, Sm, Sm, Sm, Ss, Ss, Ss, Ss, Ss, Ss, Wog^Ewf, Ss^Ewf, Rb, Ss^Ewf, Sm^Vhhr, Sm, Rb, Sm, Re, Sm, Re
Sm, Gll^Ftr, Sm, Gll^Ftr, Gll^Ftr, Ss, Ss, Gll^Ftr, Ss, Sm, Wwf, Wog^Ewf, Rb, Wog, Sm, Sm, Sm, Sm, Rb, Mm, Sm, Rb
Sm, Sm, Sm, Sm, Sm, Sm, Sm, Sm, Sm, Ss, Wwf, Sm^Bw/r, Ss, Ss, Rb, Sm, Hh, Rb, Sm, Sm, Rb^Vu, Rb
Sm, Sm, Sm, Gll^Ftr, Gll^Ftr, Sm, Sm, Sm^Vhr, Rb, Wwf, Ss, Sm, Rb, Rb, Ss, Sm, Sm, Sm, Sm, Rb, Rb, Rb
Sm, Gll^Ftr, Sm, Sm, Gll^Ftr, Rb, Sm, Rb, Ss, Ss, Wwf, Wwf, Wwf, Ss, Ss, Sm, Sm^Edb, Sm, Rb, Sm^Bw|r, Sm, Rb
Rb, Rb, Sm, Rb, Sm, Rb, Wwf, Ss, Ss^Fdw, Ss, Wog^Fetd, Wog, Ss, Ss^Vhs, Ss, Ss, Wwf, Sm, Sm, Sm, Mm, Sm
Rb, Rb^Vc, Sm, Sm^Bw|r, Sm, Sm, Ss^Fdw, Ss^Fdw, Wwf^Fdw, Sm^Fdw, Ss^Fdw, Ss^Fdw, Wwf^Fdw, Sm^Emf, Wog, Wwf, Ss, Ss, Sm, Sm^Bw|r, Sm, Sm
Rb, Sm, Ss, Wwf, Wwf, Ss, Ss^Fdw, Sm^Fdw, Sm^Fdw, Sm^Fdw, Ss^Fdw, Rb^Fdw, Rb^Fdw, Ss^Fdw, Ss^Fdw, Sm, Sm, Re, Sm, Sm^Bw|r, Sm, Sm
Rb, Rb, Rb, Rb, Ss, Sm, Ss^Fdw, Ss^Fdw, Ss^Fdw, Ss^Fdw, Sm^Fdw, Ss^Fdw, Sm, Ss^Fdw, Sm, Sm, Sm, Sm, Sm, Rb, Sm, Sm
Rb, Rb, Rb, Ss, Sm, Sm^Fdw, Ss^Fdw, Ss^Fdw, Ss^Fdw, Wwf^Fdw, Ss, Sm, Wwf, Ss, Sm, Wwf, Sm^Vht, Rb, Sm, Mm, Sm, Sm
Rb, Sm, Rb, Sm, Sm, Sm^Fdw, Ss^Fdw, Ss^Vhs, Rb^Fdw, Sm^Fetd, Wwf, Wog, Rb, Ss, Sm, Sm, Sm, Rb, Sm, Sm, Sm, Sm
Rb, Rb, Sm, Sm, Sm^Edb, Ss^Fdw, Wwf^Fdw, Ss^Fdw, Ss^Fdw, Ss^Fdw, Ss^Fdw, Wwf, Wwf, Rb, Ss, Wwf, Mm, Sm, Sm, Rb, Ss, Ss
Rb, Rb, Rb, Sm, Sm, Ss^Fdw, Wwf^Fdw, Sm^Fdw, Sm^Fdw, Wwf^Fdw, Ss^Fdw, Rb^Fetd, Ss^Fdw, Sm, Sm, Ss, Wwf, Sm^Edb, Sm, Rb, Sm, Sm
Sm, Rb, Sm, Sm, Sm, Ss^Fdw, Ss^Fdw, Ss^Fdw, Ss^Fdw, Ss^Fdw, Wog, Wog, Ss, Ss, Ss, Ss, Ss, Sm^Edb, Rb, Sm^Bw|, Sm, Sm
Chs^Xo, Chs^Xo, Chs^Xo, Chs^Xo, Chs^Xo, Chs^Xo, Chs^Xo, Chs^Xo, Chs^Xo, Khw^Xo, Chw^Xo, Chw^Xo, Khw^Xo, Chs^Xo, Chs^Xo, Chs^Xo, Chs^Xo, Chs^Xo, Chs^Xo, Chs^Xo, Chs^Xo, Chs^Xo
Gll^Fp, Gll^Fp, Gll^Fp, Re, Re, Gll^Fp, Gll^Fp, Gll^Fp, Gll^Fp, Ww, Wo, Wo, Ww, Gll^Fp, Gll^Fp, Re, Re, Gll^Fp, Gll^Fp, Gll^Fp, Gll^Fp, Gll^Fp
Gll^Fp, Gll^Fp, Gll^Fp, Gll^Fp, Gll^Fp, Re, Gll^Fp, Gll^Fp, Gll^Fp, Ww, Ww^Vm, Wo, Wo, Ww, Ww, Gll^Fp, Gll^Fp, Gll^Fp, Re, Rp^Vhcr, Gll^Fp, Gll^Fp
Gll^Fp, Gll^Fp, Hh^Fp, Gll^Fp, Hh^Fp, Hh^Fp, Re, Gll^Fp, Gll^Fp, Wwf^Fms, Wwf^Fms, Wwf^Fms, Wwf^Fms, Wo, Ww, Gll^Fp, Gll^Fp, Gll^Fp, Gll^Fp, Re, Gll^Fp, Gll^Fp
Hh^Fp, Hh^Fp, Hh^Fms, Hh^Fp, Hh^Fms, Hh^Fp, Gs^Fms, Gs^Fms, Gs^Fms, Gs^Fms, Gs^Fms, Wwf^Fms, Wwf, Wwf, Ww, Gll^Fp, Gll^Fp, Gll^Fp, Re, Gll^Fp, Gll^Fp, Gll^Fp
Hh^Fp, Hh^Fp, Gs^Fms, Hh^Fms, Hh^Fms, Re, Gs^Fms, Gs^Fms, Gg, Gg, Gg, Ww, Ww, Ww, Ww, Gll^Fp, Gll^Fp, Gll^Fp, Gll^Fp, Gll^Fp, Gll^Fp, Gll^Fp
Hh^Fms, Hh^Fms, Hh^Fms, Hh^Fms, Gs^Fms, Re, Gs^Fms, Gs^Fms, Gs^Fms, Gg, Gg, Ww, Wo, Wo, Wo, Ww, Ww, Gll^Fp, Re, Gll^Fp, Gs^Fms, Gll^Fp
Gs^Fms, Hh^Fms, Gs^Fms, Gs^Fms, Gg, Re, Gg, Gs^Fms, Gs^Fms, Gs^Fms, Gs^Fms, Ww, Ww, Wo, Wo, Ww^Vm, Ww, Gs^Fms, Gs^Fms, Re, Gs^Fms, Gs^Fms
Gs^Fms, Gg^Ve, Gs^Fms, Gs^Fms, Gg, Re, Re, Gs^Vh, Gs^Fms, Gs^Fms, Ww, Ww, Gg, Ww, Ww, Ww, Wwf, Wwf, Gs^Fms, Re, Gs^Fms, Gs^Fms
Gs^Fms, Gs^Fms, Re, Re, Gs^Fms, Gg, Hh^Fms, Re, Gs^Fms, Gs^Fms, Wwf, Gs^Fms, Gs^Fms, Gs^Fms, Gs^Fms, Gs^Fms, Gs^Fms, Gs^Fms, Gs^Fms, Re, Gs^Fms, Gs^Fms
Gs^Fms, Gs^Fms, Gs^Fms, Gs^Fms, Gs^Fms, Gs^Fms, Hh^Fms, Hh, Re, Ww, Gs^Fms, Gs^Fms, Gs^Vh, Gs^Fms, Gs^Fms, Gs^Fms, Gs^Fms, Gs^Fms, Gs^Fms, Re, Gs^Fms, Gs^Fms
Gs^Fms, Gs^Fms, Re, Gs^Fms, Gs^Fms, Hh^Fms, Hh, Hh, Re, Ww, Gs^Fms, Gs^Fms, Gg, Gs^Fms, Gg, Gs^Fms, Gg, Re, Re, Gs^Fms, Gs^Fms, Gs^Fms
Gs^Fms, Gs^Fms, Re, Gs^Fms, Gs^Fms, Hh^Fms, Hh^Fms, Hh, Gs^Fms, Ww, Re, Gs^Fms, Gg, Gg, Gg, Gg, Gs^Fms, Gs^Fms, Gs^Fms, Gs^Fms, Gs^Fms, Gs^Fms
Gs^Fds, Gs^Fms, Gs^Fms, Gs^Fms, Gs^Fms, Hh^Fms, Hh^Fms, Hh^Fms, Gs^Fms, Wwf, Gs^Fms, Gs^Fms, Gs^Fms, Gg, Gg, Gg, Gs^Fms, Gs^Fms, Gs^Fms, Gs^Vc, Gs^Fms, Gs^Fms
Gs^Fds, Gs^Fds, Re, Gs^Fms, Gs^Fms, Gs^Vl, Hh^Fms, Hh^Fms, Gs^Fms, Wwf, Gs^Fms, Gs^Fms, Gs^Fms, Gs^Fms, Gs^Fms, Gg, Re, Gs^Fms, Gs^Fms, Gs^Fms, Gs^Fms, Gs^Fms
Gs^Fds, Gs^Fds, Re, Gs^Fds, Gs^Fds, Gs^Fms, Hh^Fms, Hh^Fms, Gs^Fms, Ww, Ww, Gs^Fms, Re, Re, Gs^Fms, Gs^Fms, Re, Gs^Fms, Gs^Fms, Gs^Fms, Gs^Fms, Gs^Fms
Gs^Fds, Gs^Fds, Gs^Fds, Re, Gs^Fds, Gs^Fds, Gs^Fds, Gs^Fms, Gs^Fds, Gs^Fds, Ww, Gs^Fds, Gs^Fds, Gs^Fms, Gs^Fds, Gs^Fms, Gs^Fds, Re, Gs^Fds, Gs^Fds, Gs^Fds, Gs^Fds
Gs^Fds, Gs^Fds, Gs^Vh, Re, Re, Gs^Fds, Gs^Fds, Gs^Fds, Re, Re, Ww, Wwf, Gs^Fds, Gs^Fds, Gs^Fds, Gs^Fds, Gg^Ve, Re, Re, Gs^Fds, Gs^Fds, Gs^Fds
Gs^Fds, Gg, Gg, Gs^Fds, Gs^Fds, Gs^Fds, Re, Re, Re, Ww, Ww, Ww, Ww, Gs^Fds, Gs^Fds, Gs^Fds, Gs^Fds, Gs^Fds, Re, Gs^Fds, Gs^Fds, Gs^Fds
Gs^Fds, Gg, Gs^Fds, Gs^Fds, Gs^Fds, Gs^Fds, Gs^Fds, Gs^Fds, Re, Ww, Wo, Wo, Ww, Gs^Fds, Gs^Fds, Gs^Fds, Gs^Fds, Gs^Fds, Re, Gs^Fds, Gs^Fds, Gs^Fds
Cv^Vov, Cv^Vov, Cv^Vov, Cv^Vov, Cv^Vov, Cv^Vov, Cv^Vov, Cv^Vov, Cv^Vov, 2 Khw^Vov, Chw^Vov, Chw^Vov, 3 Khw^Vov, Cv^Vov, Cv^Vov, Cv^Vov, Cv^Vov, Cv^Vov, Cv^Vov, Cv^Vov, Cv^Vov, Cv^Vov
Gg, Gg, Gg, Gg, Gg, Gg, Re, Re, Gg, Ww, Wo, Wo, Ww, Gg, Hh^Fds, Hh^Fds, Re, Re, Gg, Gg, Gg, Gg
Gg, Gg, Gg, Gs^Vh, Gg, Gg, Re, Gg, Gg, Ww, Ww, Ww, Ww, Gg, Re, Hh^Fds, Re, Gg, Hh, Gg, Gg, Gg
Hh, Gg, Gg^Fms, Gg, Gg, Gg, Re, Gg, Gg, Wwf, Ww, Ww, Ww^Bw/, Re, Gg, Re, Gs^Fms, Re, Hh, Gg, Gg, Gg
Hh, Gg, Gg^Fms, Gg^Fms, Gg, Re, Gg, Re, Re, Ww, Ww^Bw/, Ww^Bw/, Ww, Ww, Gg, Gs^Vh, Gs^Fms, Re, Gg, Gg, Gg, Ww
Hh, Hh^Fms, Gg^Fms, Gg^Fms, Re, Re, Gg^Fms, Gg^Fms, Gg, Re, Ww, Ww, Ww, Wwf, Wwf, Gg, Gg, Re, Gg, Gg, Ww, Ww
Hh, Hh, Gg, Re, Gg, Gg, Gg^Fms, Gs^Vh, Gg^Fms, Gg, Gg, Ww, Ww, Ww, Ww, Ww, Ww, Re, Wwf, Ww, Wwf, Ww
Hh, Gg, Gg, Re, Gg, Hh, Hh^Fms, Gg^Fms, Gg^Fms, Gg, Ww, Wwf, Gg, Ww^Vm, Wo, Ww, Ww, Re, Wwf, Wwf, Wwf, Gll^Gvs
Gg, Gg, Gs^Vh, Re, Re, Gg, Hh, Hh^Fms, Gg, Gg, Wwf, Ww, Gg, Gg, Wo, Wo, Gg, Ww, Ww, Wwf, Ww, Gll^Gvs
Gg, Gg, Gg, Gg, Gg, Re, Hh, Hh, Rr, Ch, Gg, Ww, Rr, Rr, Rr, Rr, Rr^Vhc, Wwf, Wwf, Ww, Gll^Gvs, Gll^Gvs
Gg, Gg^Fms, Gg^Fms, Gg, Gg, Re, Rr, Rr, Gg, Rr, Rr, Ww^Bw/, Gg, Gg, Wo, Gg, Rr, Gg, Ww, Ww, Gll^Gvs, Gll^Gvs
Gg, Gg^Fms, Gg^Fms, Gg, Rr, Rr, Gg, Hh, Hh, Gg, Gg, Ww, Wo, Gg, Rr, Wo^Bsb/, Ww, Gg, Ww, Re, Gll^Gvs, Gll^Gvs
Gg, Gg^Fms, Gg, Gg, Rr, Gs^Vh, Gg, Hh, Hh, Gg, Gg, Ww, Wo, Rr, Wwf, Ww, Ww, Ww, Gll^Gvs, Re, Gll^Gvs, Gll^Gvs
Gg^Fms, Gg^Fms, Gg, Rr, Gg, Re, Re, Gg, Hh, Gg, Gg, Ww, Ww^Bw/, Rr, Ww^Bw\, Ww, Wwf, Wwf, Gll^Gvs, Re, Gll^Gvs, Gll^Gvs
Gg, Gg, Rr, Rr, Gg^Fms, Gg^Fms, Gg, Re, Re, Gg, Rr, Wo^Bw/, Ww, Ww, Ww, Rr, Rr, Gll^Gvs, Re, Re, Gll^Gvs, Gll^Gvs
Gg, Rr, Hh, Gs^Fms, Hh^Fms, Gg^Fms, Gg, Gg, Gg, Rr, Ww, Ww, Ww, Ww, Gll^Gvs, Gll^Gvs, Gll^Gvs, Rr, Gll^Gvs, Gll^Gvs, Gll^Gvs, Gll^Gvs
Gg, Rr, Hh, Hh, Hh, Hh, Gg, Gg, Rr, Rr, Ww^Bw\, Ww, Ww, Wwf, Rb^Eff, Gll^Gvs, Gll^Gvs, Rr, Gll^Gvs, Gg^Vwm, Gll^Gvs, Gg
Gg, Rr, Gg, Gg, Gg, Gg, Gg, Rr, Gg, Wwf, Ww, Ww^Bw\, Gg^Eff, Rb^Eff, Rb^Vh, Rb^Eff, Gll^Eff, Rr, Gll^Gvs, Gll^Gvs, Gll^Gvs, Gll^Gvs
Gg, Rr, Gg, Gg, Gs^Vh, Gg, Gg, Rr, Gg, Ww, Ww, Ww, Ww, Rb^Eff, Rb^Eff, Rb^Eff, Gll^Gvs, Rr, Gll^Gvs, Gll^Gvs, Gs^Eff, Gs^Eff
Gg, Rr, Gg, Gg, Gg, Gg, Gg, Rr, Gg, Ww, Wo, Wo, Ww, Gll^Gvs, Gll^Gvs, Gll^Gvs, Gll^Gvs, Rr, Gs^Eff, Gs^Eff, Gs, Gs
Ch, Ch, Ch, Ch, Ch, Ch, Ch, Ch, Ch, Khw, Chw, Chw, Khw, Ch, Ch, Ch, Ch, Ch, Ch, Ch, Ch, Ch
Qxua, Qxua, Qxua, Qxua, Qxua, Qxua, Qxua, Qxua, Qxua, Qxua, Qxua, Qxua, Qxua, Qxua, Qxua, Qxua, Qxua, Qxua, Qxua, Qxua, Qxua, Qxua
Xv, Xv, Xv, Xv, Xv, Xv, Xv, Xv, Xv, Xv, Xv, Xv, Xv, Xv, Xv, Xv, Xv, Xv, Xv, Xv, Xv, Xv
Xv, Xv, Xv, Xv, Xv, Xv, Xv, Xv, Xv, Xv, Xv, Xv, Xv, Xv, Xv, Xv, Xv, Xv, Xv, Xv, Xv, Xv
Xv, Xv, Xv, Xv, Xv, Xv, Xv, Xv, Xv, Xv, Xv, Xv, Xv, Xv, Xv, Xv, Xv, Xv, Xv, Xv, Xv, Xv
Xv, Xv, Xv, Xv, Xv, Xv, Xv, Xv, Xv, Xv, Xv, Xv, Xv, Xv, Xv, Xv, Xv, Xv, Xv, Xv, Xv, Xv
