border_size=1
usage=map

Xu, Xu, Xu, Xu, Xu, Xu, Xu, Xu, Xu, Xu, Xu, Xu, Xu, Xu, Xu, Xu, Xu, Xu, Xu, Xu, Xu, Xu, Xu, Xu, Xu, Xu, Xu, Xu, Xu, Xu, Xu, Xu, Xu, Xu, Xu, Xu, Xu, Xu, Xu, Xu, Xu, Xu, Xu, Xu, Xu, Xu, Xu, Xu, Xu, Xu, Xu, Xu, Xu, Xu, Xu, Xu, Xu, Xu, Xu, Xu, Xu, Xu, Xu, Xu, Xu, Xu, Xu, Xu, Xu, Xu, Xu, Xu, Xu
Xu, Xu, Xu, Xu, Xu, Xu, Gg, Xu, Xu, Xu, Wwf, Xu, Xu, Xu, Xu, Xu, Xu, Xu, Xu, Xu, Gg, Xu, Xu, Xu, Wwf, Xu, Xu, Xu, Xu, Xu, Xu, Xu, Xu, Xu, Gg, Xu, Xu, Xu, Wwf, Xu, Xu, Xu, Xu, Xu, Xu, Xu, Xu, Xu, Gg, Xu, Xu, Xu, Wwf, Xu, Xu, Xu, Xu, Xu, Xu, Xu, Xu, Xu, Gg, Xu, Xu, Xu, Wwf, Xu, Xu, Xu, Xu, Xu, Xu
Xu, Xu, Xu, Xu, Gg, Gg, Gg, Gg, Wwf^Vh, Wwf, Gg, Wwf, Wwf, Xu, Xu, Xu, Xu, Xu, Gg, Gg, Gg, Gg, Wwf^Vh, Wwf, Gg, Wwf, Wwf, Xu, Xu, Xu, Xu, Xu, Gg, Gg, Gg, Gg, Wwf^Vh, Wwf, Gg, Wwf, Wwf, Xu, Xu, Xu, Xu, Xu, Gg, Gg, Gg, Gg, Wwf^Vh, Wwf, Gg, Wwf, Wwf, Xu, Xu, Xu, Xu, Xu, Gg, Gg, Gg, Gg, Wwf^Vh, Wwf, Gg, Wwf, Wwf, Xu, Xu, Xu, Xu
Xu, Xu, Xu, Xu, Gg, Gg, Gg, Xu, Xu, Xu, Gg, Gg, Wwf, Xu, Xu, Xu, Xu, Xu, Gg, Gg, Gg, Xu, Xu, Xu, Gg, Gg, Wwf, Xu, Xu, Xu, Xu, Xu, Gg, Gg, Gg, Xu, Xu, Xu, Gg, Gg, Wwf, Xu, Xu, Xu, Xu, Xu, Gg, Gg, Gg, Xu, Xu, Xu, Gg, Gg, Wwf, Xu, Xu, Xu, Xu, Xu, Gg, Gg, Gg, Xu, Xu, Xu, Gg, Gg, Wwf, Xu, Xu, Xu, Xu
Xu, Xu, Xu, Xu, Wwf, Gg, Wwf, Gg, Gg, Gg, Wwf, Gg, Wwf, Xu, Xu, Xu, Xu, Xu, Wwf, Gg, Wwf, Gg, Gg, Gg, Wwf, Gg, Wwf, Xu, Xu, Xu, Xu, Xu, Wwf, Gg, Wwf, Gg, Gg, Gg, Wwf, Gg, Wwf, Xu, Xu, Xu, Xu, Xu, Wwf, Gg, Wwf, Gg, Gg, Gg, Wwf, Gg, Wwf, Xu, Xu, Xu, Xu, Xu, Wwf, Gg, Wwf, Gg, Gg, Gg, Wwf, Gg, Wwf, Xu, Xu, Xu, Xu
Xu, Xu, Wwf, Wwf, Hh, Wwf, Hh, Wwf, Hh^Fms, Wwf, Gs^Fms, Wwf, Gll^Ftr, Gg, Gg, Xu, Wwf, Wwf, Hh, Wwf, Hh, Wwf, Hh^Fms, Wwf, Gs^Fms, Wwf, Gll^Ftr, Gg, Gg, Xu, Wwf, Wwf, Hh, Wwf, Hh, Wwf, Hh^Fms, Wwf, Gs^Fms, Wwf, Gll^Ftr, Gg, Gg, Xu, Wwf, Wwf, Hh, Wwf, Hh, Wwf, Hh^Fms, Wwf, Gs^Fms, Wwf, Gll^Ftr, Gg, Gg, Xu, Wwf, Wwf, Hh, Wwf, Hh, Wwf, Hh^Fms, Wwf, Gs^Fms, Wwf, Gll^Ftr, Gg, Gg, Xu, Xu
Xu, Xu, Wwf, Gg^Vhh, Xu, Gg, Xu, Wwf, Xu, Wwf, Xu, Gg, Xu, Gg^Ve, Gg, Xu, Wwf, Gg^Vhh, Xu, Gg, Xu, Wwf, Xu, Wwf, Xu, Gg, Xu, Gg^Ve, Gg, Xu, Wwf, Gg^Vhh, Xu, Gg, Xu, Wwf, Xu, Wwf, Xu, Gg, Xu, Gg^Ve, Gg, Xu, Wwf, Gg^Vhh, Xu, Gg, Xu, Wwf, Xu, Wwf, Xu, Gg, Xu, Gg^Ve, Gg, Xu, Wwf, Gg^Vhh, Xu, Gg, Xu, Wwf, Xu, Wwf, Xu, Gg, Xu, Gg^Ve, Gg, Xu, Xu
Xu, Xu, Hh, Wwf, Wwf, Gg, Gg, Wwf, Wwf, Wwf, Gg, Gg, Gg, Gg, Gs^Fds, Xu, Hh, Wwf, Wwf, Gg, Gg, Wwf, Wwf, Wwf, Gg, Gg, Gg, Gg, Gs^Fds, Xu, Hh, Wwf, Wwf, Gg, Gg, Wwf, Wwf, Wwf, Gg, Gg, Gg, Gg, Gs^Fds, Xu, Hh, Wwf, Wwf, Gg, Gg, Wwf, Wwf, Wwf, Gg, Gg, Gg, Gg, Gs^Fds, Xu, Hh, Wwf, Wwf, Gg, Gg, Wwf, Wwf, Wwf, Gg, Gg, Gg, Gg, Gs^Fds, Xu, Xu
Xu, Xu, Xu, Hh, Wwf, Gg, Wwf, Gg, Gg, Gg, Wwf, Gg, Gg, Gll^Fp, Xu, Xu, Xu, Hh, Wwf, Gg, Wwf, Gg, Gg, Gg, Wwf, Gg, Gg, Gll^Fp, Xu, Xu, Xu, Hh, Wwf, Gg, Wwf, Gg, Gg, Gg, Wwf, Gg, Gg, Gll^Fp, Xu, Xu, Xu, Hh, Wwf, Gg, Wwf, Gg, Gg, Gg, Wwf, Gg, Gg, Gll^Fp, Xu, Xu, Xu, Hh, Wwf, Gg, Wwf, Gg, Gg, Gg, Wwf, Gg, Gg, Gll^Fp, Xu, Xu, Xu
Xu, Xu, Xu, Xu, Gg, Wwf, Ch, Wwf, Wwf, Wwf, Ch, Wwf, Wwt, Xu, Xu, Xu, Xu, Xu, Gg, Wwf, Ch, Wwf, Wwf, Wwf, Ch, Wwf, Wwt, Xu, Xu, Xu, Xu, Xu, Gg, Wwf, Ch, Wwf, Wwf, Wwf, Ch, Wwf, Wwt, Xu, Xu, Xu, Xu, Xu, Gg, Wwf, Ch, Wwf, Wwf, Wwf, Ch, Wwf, Wwt, Xu, Xu, Xu, Xu, Xu, Gg, Wwf, Ch, Wwf, Wwf, Wwf, Ch, Wwf, Wwt, Xu, Xu, Xu, Xu
Xu, Xu, Uu, Uu, Ch, Dd^Vdt, Xu, Ch, 1 Kh^Vwm, Ch, Xu, Aa^Vaa, Ch, Wwt, Xu, Xu, Uu, Uu, Ch, Dd^Vdt, Xu, Ch, 4 Kh^Vwm, Ch, Xu, Aa^Vaa, Ch, Wwt, Xu, Xu, Uu, Uu, Ch, Dd^Vdt, Xu, Ch, 2 Kh^Vwm, Ch, Xu, Aa^Vaa, Ch, Wwt, Xu, Xu, Uu, Uu, Ch, Dd^Vdt, Xu, Ch, 5 Kh^Vwm, Ch, Xu, Aa^Vaa, Ch, Wwt, Xu, Xu, Uu, Uu, Ch, Dd^Vdt, Xu, Ch, 3 Kh^Vwm, Ch, Xu, Aa^Vaa, Ch, Wwt, Xu, Xu, Xu
Xu, Xu, Uu, Xu, Xu, Ch, Ch, Ch, Xu, Ch, Ch, Ch, Xu, Wot, Wot, Xu, Uu, Xu, Xu, Ch, Ch, Ch, Xu, Ch, Ch, Ch, Xu, Wot, Wot, Xu, Uu, Xu, Xu, Ch, Ch, Ch, Xu, Ch, Ch, Ch, Xu, Wot, Wot, Xu, Uu, Xu, Xu, Ch, Ch, Ch, Xu, Ch, Ch, Ch, Xu, Wot, Wot, Xu, Uu, Xu, Xu, Ch, Ch, Ch, Xu, Ch, Ch, Ch, Xu, Wot, Wot, Xu, Xu
Xu, Xu, Xu, Uu, Uu, Xu, Xu, Xu, Xu, Xu, Xu, Xu, Xu, Xu, Wot, Xu, Xu, Uu, Uu, Xu, Xu, Xu, Xu, Xu, Xu, Xu, Xu, Xu, Wot, Xu, Xu, Uu, Uu, Xu, Xu, Xu, Wog, Xu, Xu, Xu, Xu, Xu, Wot, Xu, Xu, Uu, Uu, Xu, Xu, Xu, Xu, Xu, Xu, Xu, Xu, Xu, Wot, Xu, Xu, Uu, Uu, Xu, Xu, Xu, Xu, Xu, Xu, Xu, Xu, Xu, Wot, Xu, Xu
Xu, Xu, Xu, Xu, Uu, Xu, Xu, Xu, Xu, Xu, Xu, Xu, Xu, Xu, Wot, Xu, Xu, Xu, Uu, Xu, Xu, Xu, Xu, Xu, Xu, Xu, Xu, Xu, Wot, Xu, Xu, Xu, Uu, Xu, Xu, Wog, Xu, Wog, Wog, Xu, Xu, Xu, Wot, Xu, Xu, Xu, Uu, Xu, Xu, Xu, Xu, Xu, Xu, Xu, Xu, Xu, Wot, Xu, Xu, Xu, Uu, Xu, Xu, Xu, Xu, Xu, Xu, Xu, Xu, Xu, Wot, Xu, Xu
Xu, Xu, Xu, Xu, Uu, Xu, Uu, Xu, Uu, Xu, Xu, Xu, Xu, Xu, Wot^Vm, Xu, Xu, Xu, Uu, Xu, Uu, Xu, Uu, Xu, Xu, Xu, Xu, Xu, Wot^Vm, Xu, Xu, Xu, Uu, Xu, Uu, Xu, Uu, Xu, Xu, Wog, Wog, Xu, Wot^Vm, Xu, Xu, Xu, Uu, Xu, Uu, Xu, Uu, Xu, Xu, Xu, Xu, Xu, Wot^Vm, Xu, Xu, Xu, Uu, Xu, Uu, Xu, Uu, Xu, Xu, Xu, Xu, Xu, Wot^Vm, Xu, Xu
Xu, Xu, Xu, Uu, Xu, Uu, Xu, Uu, Qlf, Uu, Uu^Vu, Xu, Xu, Xu, Wwf, Xu, Xu, Uu, Xu, Uu, Xu, Uu, Qlf, Uu, Uu^Vu, Xu, Xu, Xu, Wwf, Xu, Xu, Uu, Xu, Uu, Xu, Uu, Qlf, Uu, Uu^Vu, Xu, Wog, Xu, Wwf, Xu, Xu, Uu, Xu, Uu, Xu, Uu, Qlf, Uu, Uu^Vu, Xu, Xu, Xu, Wwf, Xu, Xu, Uu, Xu, Uu, Xu, Uu, Qlf, Uu, Uu^Vu, Xu, Xu, Xu, Wwf, Xu, Xu
Xu, Xu, Xu, Uu, Uu, Xu, Uu, Xu, Uu, Uu, Xu, Xu, Xu, Xu, Xu, Xu, Xu, Uu, Uu, Xu, Uu, Xu, Uu, Uu, Xu, Xu, Xu, Xu, Xu, Xu, Xu, Uu, Uu, Xu, Uu, Xu, Uu, Uu, Xu, Xu, Xu, Wog, Xu, Xu, Xu, Uu, Uu, Xu, Uu, Xu, Uu, Uu, Xu, Xu, Xu, Xu, Xu, Xu, Xu, Uu, Uu, Xu, Uu, Xu, Uu, Uu, Xu, Xu, Xu, Xu, Xu, Xu, Xu
Xu, Xu, Xu, Xu, Xu, Uu, Xu, Uu, Xu, Xu, Xu, Xu, Xu, Xu, Xu, Xu, Xu, Xu, Xu, Uu, Xu, Uu, Xu, Xu, Xu, Xu, Xu, Xu, Xu, Xu, Xu, Xu, Xu, Uu, Xu, Uu, Xu, Xu, Wog, Xu, Xu, Wog, Xu, Xu, Xu, Xu, Xu, Uu, Xu, Uu, Xu, Xu, Xu, Xu, Xu, Xu, Xu, Xu, Xu, Xu, Xu, Uu, Xu, Uu, Xu, Xu, Xu, Xu, Xu, Xu, Xu, Xu, Xu
Xu, Xu, Xu, Xu, Xu, Xu, Xu, Xu, Xu, Xu, Xu, Xu, Xu, Xu, Xu, Xu, Xu, Xu, Xu, Xu, Xu, Xu, Xu, Xu, Xu, Xu, Xu, Xu, Xu, Xu, Xu, Xu, Xu, Xu, Xu, Xu, Wog, Wog, Xu, Wog, Wog, Wog, Xu, Xu, Xu, Xu, Xu, Xu, Xu, Xu, Xu, Xu, Xu, Xu, Xu, Xu, Xu, Xu, Xu, Xu, Xu, Xu, Xu, Xu, Xu, Xu, Xu, Xu, Xu, Xu, Xu, Xu, Xu
Xu, Xu, Xu, Xu, Xu, Xu, Xu, Xu, Xu, Xu, Xu, Xu, Xu, Xu, Xu, Xu, Xu, Xu, Xu, Xu, Xu, Xu, Xu, Xu, Xu, Xu, Xu, Xu, Xu, Xu, Xu, Xu, Xu, Xu, Xu, Xu, Xu, Xu, Xu, Xu, Xu, Xu, Xu, Xu, Xu, Xu, Xu, Xu, Xu, Xu, Xu, Xu, Xu, Xu, Xu, Xu, Xu, Xu, Xu, Xu, Xu, Xu, Xu, Xu, Xu, Xu, Xu, Xu, Xu, Xu, Xu, Xu, Xu
