border_size=1
usage=map

_off^_usr, _off^_usr, _off^_usr, _off^_usr, _off^_usr, _off^_usr, _off^_usr, _off^_usr, _off^_usr, _off^_usr, _off^_usr, _off^_usr, _off^_usr, _off^_usr, _off^_usr, _off^_usr, _off^_usr, _off^_usr, _off^_usr, _off^_usr, _off^_usr, _off^_usr, _off^_usr, _off^_usr, _off^_usr, _off^_usr, _off^_usr, _off^_usr, _off^_usr, _off^_usr, _off^_usr, _off^_usr, _off^_usr, _off^_usr, _off^_usr
_off^_usr, _off^_usr, _off^_usr, _off^_usr, _off^_usr, _off^_usr, _off^_usr, _off^_usr, _off^_usr, _off^_usr, _off^_usr, _off^_usr, _off^_usr, _off^_usr, _off^_usr, _off^_usr, Xuce, Xv^Eff, Xuc, _off^_usr, _off^_usr, _off^_usr, _off^_usr, _off^_usr, _off^_usr, _off^_usr, _off^_usr, _off^_usr, _off^_usr, _off^_usr, _off^_usr, _off^_usr, _off^_usr, _off^_usr, _off^_usr
_off^_usr, _off^_usr, _off^_usr, _off^_usr, _off^_usr, _off^_usr, _off^_usr, _off^_usr, _off^_usr, _off^_usr, _off^_usr, _off^_usr, _off^_usr, _off^_usr, Xuce, Xuce, Wog, Xol, Dd^Ftd, Xuc, Xuc, _off^_usr, _off^_usr, _off^_usr, _off^_usr, _off^_usr, _off^_usr, _off^_usr, _off^_usr, _off^_usr, _off^_usr, _off^_usr, _off^_usr, _off^_usr, _off^_usr
_off^_usr, _off^_usr, _off^_usr, _off^_usr, _off^_usr, _off^_usr, _off^_usr, _off^_usr, _off^_usr, _off^_usr, _off^_usr, _off^_usr, Xuce, Xuce, Wwg, Wog, Wog, Xol, Rd, Rd, Dd, Xuc, Xuc, _off^_usr, _off^_usr, _off^_usr, _off^_usr, _off^_usr, _off^_usr, _off^_usr, _off^_usr, _off^_usr, _off^_usr, _off^_usr, _off^_usr
_off^_usr, _off^_usr, _off^_usr, _off^_usr, _off^_usr, _off^_usr, _off^_usr, _off^_usr, _off^_usr, _off^_usr, Xuce, Xuce, Wog, Wog, Wwg, Wwrg, Wog, Wwf, Dd, Gd, Gd^Fts, Dd, Rd, Xuc, Xuc, _off^_usr, _off^_usr, _off^_usr, _off^_usr, _off^_usr, _off^_usr, _off^_usr, _off^_usr, _off^_usr, _off^_usr
_off^_usr, _off^_usr, _off^_usr, _off^_usr, _off^_usr, _off^_usr, _off^_usr, _off^_usr, Xue, Xv^Fet, Xuc, Wog, Wog, Wwrg, Wwg, Wwg, Wwg, Wwf, Dd, Gd^Fts, Gd^Fts, Gd, Rd, Dd^Ftd, Xue, Xv^Vu, Xu, _off^_usr, _off^_usr, _off^_usr, _off^_usr, _off^_usr, _off^_usr, _off^_usr, _off^_usr
_off^_usr, _off^_usr, _off^_usr, _off^_usr, _off^_usr, _off^_usr, Xue, Xue, Hd^Edt, Xos, Ms^Xm, Xuc, Wwf, Wwg, Wog, Wwrg, Wog, Wwf, Rd, Gd, Dd, Dd, Wwf, Xue, Gg^Fet, Xol, Ms^Xm, Xu, Xu, _off^_usr, _off^_usr, _off^_usr, _off^_usr, _off^_usr, _off^_usr
_off^_usr, _off^_usr, _off^_usr, _off^_usr, Xue, Xue, Hh^Fms, Hhd^Fdw, Hhd^Fdw, Xos, Aa^Fma, Aa^Fma, Aa, Wwf, Xuc, Wog, Wog, Xol, Dd^Ftd, Rd, Xue, Wwf, Gg, Gs^Fms, Gs^Fds, Xol, Ms, Ms, Ha, Xu, Xu, _off^_usr, _off^_usr, _off^_usr, _off^_usr
_off^_usr, _off^_usr, Xue, Xue, Hhd^Fdw, Hh^Fms, Gg^Fds, Hh^Fms, Hh^Fms, Wwf, Aa, Ha^Fma, Ai, Ha, Cud, Xuc, Xuc, Xol, Xue, Xue, Co, Gs^Fms, Gg, Gll^Ftr, Gg, Wwf, Ha, Ha, Ai, Ha, Ms, Xu, Xu, _off^_usr, _off^_usr
_off^_usr, Xv^Edp, Xuc, Hd^Edb, Hhd^Fdw, Hh^Fms, Gg^Fds, Gg^Fds, Hh^Fms, Wwf, Ha, Ai, 4 Kud, Cud, Aa^Vla, Cud, Xuce, Ms^Xm, Xu, Co, Gg^Ve, Co, 2 Ko, Gg, Gs^Fms, Wwf, Ha, Ai, Ai, Ha, Ms, Ms^Xm, Xuce, Xv^Gvs, _off^_usr
_off^_usr, Xol, Hh, Xuc, Wwf, Hh^Fms, Hh^Fms, Hh^Fms, Hhd^Fdw, Xos, Cud, Cud, Cud, Cud, Xuce, Xuce, Uu, Xos, Hh, Xu, Xu, Co, Co, Co, Co, Xol, Ms, Ha, Ha, Ha, Wwf, Xuce, Qlf, Xol, _off^_usr
_off^_usr, Xol, Mm, Mm, Mm, Wwf, Wwf, Hhd^Fdw, Hd^Edt, Xos, Cud, Aa^Vla, Xuce, Xuce, Uh, Uu, Uu, Xos, Hh, Mm, Hh, Xu, Xu, Gg^Ve, Co, Xol, Ms^Xm, Ms, Wwf, Wwf, Urb^Br\, Ql, Ql, Xol, _off^_usr
_off^_usr, Xol, Mm, Mm^Xm, Mm^Xm, Mm, Mm, Xuc, Xuc, Xos, Xuce, Xuce, Uu, Uh, Qxu, Uu, Ur, Xos, Hh, Mm^Dr, Mm^Dr, Hh, Mm, Xu, Xu, Xol, Xuce, Xuce, Ql, Urb^Br|, Ql, Ql^Br\, Urb^Br\, Xol, _off^_usr
_off^_usr, Xol, Mm, Mm^Xm, Mm^Xm, Mm^Xm, Mm, Hh, Xue, Qxu, Xu, Uu, Uu, Uu, Uu, Uu, Qlf, Wwf, Mm, Hh, Hh, Mm^Dr, Hh, Hh, Xue, Qxe, Xuc, Qlf, Ql, Ql^Br|, Ql, Ql, Urb^Br/, Xol, _off^_usr
_off^_usr, Xol, Mm, Mm^Xm, Mm, Mm, Xue, Xue, Cd, Xol, Rd, Xu, Xu, Ur, Qlf, Uh, Uu, Xos, Mm, Mm, Mm, Hh, Xue, Xue, Wwf, Xos, Chw, Xuc, Xuc, Urb^Br|, Urb^Br/, Ql^Br/, Ql, Xol, _off^_usr
_off^_usr, Xol, Hh, Mm, Wwf, Wwf, Wwrt, Cd, Ww^Vm, Xol, Dd, Rd, Dd, Wwf, Xu, Uu, Uu^Vud, Xos, Hh^Vhh, Mm, Xue, Wwf, Wwf, Wwf, Wwf, Xos, Dd^Vda, Chw, Hd, Wwf, Wwf, Ql, Qlf, Xol, _off^_usr
_off^_usr, Xol, Xue, Xue, Sm, Wwt, Wwt, Cd, Cd, Xol, Rd, Dd, Md, Dd, Hd, Xu, Wwf, Wwf, Wwf, Xue, Wot, Wwt, Wwt, Wwt^Ewf, Wwf, Xos, Chw, Chw, Dd, Rd, Ds, Xuc, Xuc, Xol, _off^_usr
_off^_usr, Xv^Ecf, Xu, Wot, Sm, Wot, Wwt, 1 Kd, Cd, Xol, Rd, Rd, Md, Dd, Hd, Dd^Vda, Wwf, Xv, Wwf, Ww^Vm, Wot, Wot, Wwt, Wwt, Wwf, Xos, Chw, 5 Khw, Dd, Dd^Dc, Ds, Md^Xm, Xuce, Xv^Wm, _off^_usr
_off^_usr, Xos, Aa^Fda, Xu, Wwf, Wwt, Wwrt, Cd, Ww^Vm, Xol, Dd, Dd, Dd, Dd, Xuce, Xuce, Gg^Ve, Wwf, Aa^Vla, Xuc, Xuc, Wwt, Wwf, Wwt^Ewf, Wwf, Xos, Dd^Vda, Chw, Hd, Rd, Wwf, Xuce, Gll^Fdf, Xos, _off^_usr
_off^_usr, Xos, Aa^Fpa, Aa^Fpa, Gll^Fdw, Wwf, Xu, Cd, Cd, Xol, Rd, Rd, Xuce, Wwf, Gg^Fet, Gs^Fms, Gs^Fms, Xol, Ha, Ha, Ms^Xm, Wwf, Xuc, Wwf, Wwf, Xos, Chw, Chw, Xuce, Wwf, Gll^Fmf, Gll^Fdf, Gll^Fdf, Xos, _off^_usr
_off^_usr, Xos, Gll^Fdw, Aa^Fma, Aa^Fpa, Gll^Fdw, Aa^Fpa, Xu, Xu, Xol, Xuce, Xuce, Gs^Fms, Gs^Fms, Gs^Fms, Gs^Fms, Gg^Fet, Xol, Ms^Xm, Aa, Aa, Ai, Ai, Xuc, Xuc, Xos, Xuce, Xuce, Gll^Fdf, Gll^Fmf, Gll^Fdf, Gll^Fdf, Gll^Fmf, Xos, _off^_usr
_off^_usr, Xos, Gll^Fdw, Aa^Fpa, Aa^Fpa, Aa^Fma, Aa^Fpa, Aa^Fda, Xue, Md^Xm, Xuc, Gs^Fms, Gs^Fms, Gs^Fms, Gs^Fms, Gs^Fms, Gs^Fms, Wwf, Ai, Aa, Ms, Aa, Ai, Ai, Xue, Mm^Xm, Xu, Gll^Fdf, Gll^Fdf, Gll^Fdf, Gll^Fdf, Gll^Fdf, Gll^Fmf, Xos, _off^_usr
_off^_usr, Xos, Aa^Fpa, Aa^Fma, Gll^Fdw, Gll^Fdw, Wwf, Xue, Uue, Xos, Cv, Xuc, Xuc, Gs^Fms, Gs^Fms, Gs^Fms, Gs^Fms, Xol, Ai, Aa, Ai, Ai, Xue, Xue, Cha, Xol, Mv, Xu, Wwf, Gll^Fmf, Gll^Fmf, Gll^Fdf, Gll^Fdf, Xos, _off^_usr
_off^_usr, Xos, Aa^Fda, Aa^Fpa, Wwf, Wwf, Uue, Uue^Uf, Uue^Uf, Xos, Cv, Hh^Vhh, Cv, Xuc, Xuc, Gs^Fms, Gs^Fms, Xol, Ai, Ai, Xue, Xue, Cha, Uu^Vud, Cha, Xol, Qlf, Qlf, Hhd, Wwf, Wwf, Gll^Fdf, Gll^Fdf, Xos, _off^_usr
_off^_usr, Xos, Xue, Xue, Uue^Uf, Uue, Qxe, Xue, Uue, Xos, Mm, Cv, 6 Kv, Cv, Hh^Vhh, Xuc, Xuc, Xol, Xue, Xue, Uu^Vud, Cha, 3 Kha, Cha, Uh, Xol, Hhd, Qlf^Dr, Mm, Hhd, Qlf, Xu, Xu, Xos, _off^_usr
_off^_usr, Xv^Efm, Xuc, Uue, Uue^Uf, Xue, Qxe, Qxe, Uue, Wwf, Ha, Gg, Gg, Cv, Cv, Cv, Xuce, Qxua, Xu, Cha, Cha, Cha, Ur, Ur, Ur, Wwf, Hhd, Mm, Mm, Qlf^Dr, Qlf, Mv, Xuce, Xv^Emf, _off^_usr
_off^_usr, _off^_usr, _off^_usr, Xuc, Xuc, Uue, Uue, Xue, Uue^Uf, Wwf, Hh, Hd, Uh, Mm, Xuce, Xuce, Ss^Efm, Xos, Dd, Xu, Xu, Uh, Ur, Ql, Uu^Uf, Wwf, Qlf, Qlf^Dr, Hhd, Hhd, Xuce, Xuce, _off^_usr, _off^_usr, _off^_usr
_off^_usr, _off^_usr, _off^_usr, _off^_usr, _off^_usr, Xuc, Xuc, Uue^Uf, Uue, Xos, Mm^Xm, Hh, Wwf, Wwf, Ss^Efm, Wwf, Wwf, Xos, Hd, Hd, Md, Wwf, Wwf, Uu^Uf, Qxua, Xol, Mv, Qlf, Xuce, Xuce, _off^_usr, _off^_usr, _off^_usr, _off^_usr, _off^_usr
_off^_usr, _off^_usr, _off^_usr, _off^_usr, _off^_usr, _off^_usr, _off^_usr, Xuc, Xuc, Xos, Xuce, Xuce, Wwf, Ss^Efm, Ss^Efm, Ss^Ewf, Ss^Efm, Wwf, Md, Hd, Md^Xm, Md, Hd, Xu, Xu, Xol, Xuce, Xuce, _off^_usr, _off^_usr, _off^_usr, _off^_usr, _off^_usr, _off^_usr, _off^_usr
_off^_usr, _off^_usr, _off^_usr, _off^_usr, _off^_usr, _off^_usr, _off^_usr, _off^_usr, _off^_usr, Xv^Vm, Xu, Ss^Efm, Wwf, Ss^Ewf, Ss^Efm, Ss^Efm, Ss^Efm, Wwf, Md, Md^Xm, Md^Xm, Hd, Hd, Dd, Xue, Xv^Dr, _off^_usr, _off^_usr, _off^_usr, _off^_usr, _off^_usr, _off^_usr, _off^_usr, _off^_usr, _off^_usr
_off^_usr, _off^_usr, _off^_usr, _off^_usr, _off^_usr, _off^_usr, _off^_usr, _off^_usr, _off^_usr, _off^_usr, _off^_usr, Xu, Xu, Ss^Efm, Ss^Efm, Ss^Ewf, Wwf, Wwf, Hd, Hd, Md, Md, Xue, Xue, _off^_usr, _off^_usr, _off^_usr, _off^_usr, _off^_usr, _off^_usr, _off^_usr, _off^_usr, _off^_usr, _off^_usr, _off^_usr
_off^_usr, _off^_usr, _off^_usr, _off^_usr, _off^_usr, _off^_usr, _off^_usr, _off^_usr, _off^_usr, _off^_usr, _off^_usr, _off^_usr, _off^_usr, Xu, Xu, Wwf, Ss^Efm, Xos, Dd, Hd, Xue, Xue, _off^_usr, _off^_usr, _off^_usr, _off^_usr, _off^_usr, _off^_usr, _off^_usr, _off^_usr, _off^_usr, _off^_usr, _off^_usr, _off^_usr, _off^_usr
_off^_usr, _off^_usr, _off^_usr, _off^_usr, _off^_usr, _off^_usr, _off^_usr, _off^_usr, _off^_usr, _off^_usr, _off^_usr, _off^_usr, _off^_usr, _off^_usr, _off^_usr, Xu, Xu, Xos, Xue, Xue, _off^_usr, _off^_usr, _off^_usr, _off^_usr, _off^_usr, _off^_usr, _off^_usr, _off^_usr, _off^_usr, _off^_usr, _off^_usr, _off^_usr, _off^_usr, _off^_usr, _off^_usr
_off^_usr, _off^_usr, _off^_usr, _off^_usr, _off^_usr, _off^_usr, _off^_usr, _off^_usr, _off^_usr, _off^_usr, _off^_usr, _off^_usr, _off^_usr, _off^_usr, _off^_usr, _off^_usr, _off^_usr, Xv^Ewl, _off^_usr, _off^_usr, _off^_usr, _off^_usr, _off^_usr, _off^_usr, _off^_usr, _off^_usr, _off^_usr, _off^_usr, _off^_usr, _off^_usr, _off^_usr, _off^_usr, _off^_usr, _off^_usr, _off^_usr
_off^_usr, _off^_usr, _off^_usr, _off^_usr, _off^_usr, _off^_usr, _off^_usr, _off^_usr, _off^_usr, _off^_usr, _off^_usr, _off^_usr, _off^_usr, _off^_usr, _off^_usr, _off^_usr, _off^_usr, _off^_usr, _off^_usr, _off^_usr, _off^_usr, _off^_usr, _off^_usr, _off^_usr, _off^_usr, _off^_usr, _off^_usr, _off^_usr, _off^_usr, _off^_usr, _off^_usr, _off^_usr, _off^_usr, _off^_usr, _off^_usr
