border_size=1
usage=map

_off^_usr, _off^_usr, _off^_usr, _off^_usr, _off^_usr, _off^_usr, _off^_usr, _off^_usr, _off^_usr, _off^_usr, _off^_usr, _off^_usr, _off^_usr, _off^_usr, _off^_usr, _off^_usr, _off^_usr, _off^_usr, _off^_usr, _off^_usr, _off^_usr, _off^_usr, _off^_usr
_off^_usr, _off^_usr, _off^_usr, _off^_usr, _off^_usr, _off^_usr, _off^_usr, _off^_usr, _off^_usr, _off^_usr, _off^_usr, _off^_usr, _off^_usr, _off^_usr, _off^_usr, _off^_usr, _off^_usr, _off^_usr, _off^_usr, _off^_usr, _off^_usr, _off^_usr, _off^_usr
_off^_usr, _off^_usr, _off^_usr, _off^_usr, _off^_usr, _off^_usr, _off^_usr, _off^_usr, _off^_usr, _off^_usr, _off^_usr, _off^_usr, _off^_usr, _off^_usr, _off^_usr, _off^_usr, _off^_usr, _off^_usr, _off^_usr, _off^_usr, _off^_usr, _off^_usr, _off^_usr
_off^_usr, _off^_usr, _off^_usr, _off^_usr, _off^_usr, _off^_usr, _off^_usr, _off^_usr, _off^_usr, _off^_usr, Ql, Ql, Ql, _off^_usr, _off^_usr, _off^_usr, _off^_usr, _off^_usr, _off^_usr, _off^_usr, _off^_usr, _off^_usr, _off^_usr
_off^_usr, _off^_usr, _off^_usr, _off^_usr, _off^_usr, _off^_usr, _off^_usr, _off^_usr, Ql, Ql, Cud, 1 Kud, Cud, Ql, Ql, _off^_usr, _off^_usr, _off^_usr, _off^_usr, _off^_usr, _off^_usr, _off^_usr, _off^_usr
_off^_usr, _off^_usr, _off^_usr, _off^_usr, _off^_usr, _off^_usr, Ql, Ql, Gd^Fdw, Gd^Fdw, Hhd, Cud, Wwf, Wwf, Wwf, Ql, Ql, _off^_usr, _off^_usr, _off^_usr, _off^_usr, _off^_usr, _off^_usr
_off^_usr, _off^_usr, _off^_usr, _off^_usr, Ql, Ql, 5 Kud, Cud, Gd, Gd^Ve, Gs, Cud, Wwf, Hhd^Vhh, Gd, Cud, 6 Kud, Ql, Ql, _off^_usr, _off^_usr, _off^_usr, _off^_usr
_off^_usr, _off^_usr, Ql, Ql, Wwf, Cud, Cud, Cud, Gs, Gs, Gs, Ds, Wwf, Hh, Gs, Cud, Cud, Cud, Gd^Fdw, Ql, Ql, _off^_usr, _off^_usr
_off^_usr, _off^_usr, Ql, Hhd, Gd^Vh, Wwf, Wwf, Ds, Hh, Gs^Fms, Gg, Gg^Vh, Wwf, Gs, Mm, Gs, Hh, Gd, Gd^Vh, Hhd, Ql, _off^_usr, _off^_usr
_off^_usr, _off^_usr, Ql, Gd^Fdw, Gd, Gs^Fmf, Gs, Wwf, Wwf, Mm, Wwf, Wwf, Ds^Uf, Gg, Gs^Fp, Gs, Gs, Gs^Fmf, Wwf, Wwf, Ql, _off^_usr, _off^_usr
_off^_usr, _off^_usr, Ql, Cud, Cud, Hh, Gs, Hh, Ss^Vhs, Ss, Wwf, Gs^Fms, Hh, Gg, Ss^Vhs, Hh, Wwf, Wwf, Cud, Cud, Ql, _off^_usr, _off^_usr
_off^_usr, _off^_usr, Ql, 9 Kud, Cud, Gs, Mm, Gs^Fp, Gg, Gg^Efm, Wwf, Wwf, Wwf, Gg^Efm, Ss, Wwf, Hh, Ds, Cud, 2 Kud, Ql, _off^_usr, _off^_usr
_off^_usr, _off^_usr, Ql, Cud, Gll^Fmf, Gs, Gs, Gg, Ds^Uf, Hh, Wwf, Gg^Ve, Wwf, Wwf, Wwf, Mm, Gs^Fms, Gs, Gd, Cud, Ql, _off^_usr, _off^_usr
_off^_usr, _off^_usr, Ql, Wwf, Hhd^Vhh, Hh, Wwf, Wwf, Wwf, Gs^Fms, Wwf, Wwf, Hh, Gs^Fms, Wwf, Gg, Gs, Gs, Gd^Ve, Gd^Fdw, Ql, _off^_usr, _off^_usr
_off^_usr, _off^_usr, Ql, Wwf, Wwf, Wwf, Ds, Gg^Vh, Gg, Wwf, Ss, Gg^Efm, Gg, Ds^Uf, Wwf, Gg^Vh, Ds, Gs, Hhd, Gd^Fdw, Ql, _off^_usr, _off^_usr
_off^_usr, _off^_usr, Ql, Cud, Cud, Cud, Gs, Gs, Gs^Fms, Mm, Wwf, Ss^Vhs, Gs^Fp, Gg, Gs, Wwf, Wwf, Cud, Cud, Cud, Ql, _off^_usr, _off^_usr
_off^_usr, _off^_usr, Ql, 4 Kud, Cud, Hhd, Gd^Ve, Gs, Gs, Hh, Wwf, Hh, Gs, Mm, Gs, Hh, Hhd^Vhh, Wwf, Cud, 7 Kud, Ql, _off^_usr, _off^_usr
_off^_usr, _off^_usr, _off^_usr, Ql, Ql, Gd^Fdw, Gd^Fdw, Gd, Cud, Ds, Wwf, Gs, Hh, Gs, Cud, Gd^Fmf, Wwf, Wwf, Ql, Ql, _off^_usr, _off^_usr, _off^_usr
_off^_usr, _off^_usr, _off^_usr, _off^_usr, _off^_usr, Ql, Ql, Cud, 8 Kud, Cud, Wwf, Gs^Fmf, Gd, Cud, 3 Kud, Cud, Ql, Ql, _off^_usr, _off^_usr, _off^_usr, _off^_usr, _off^_usr
_off^_usr, _off^_usr, _off^_usr, _off^_usr, _off^_usr, _off^_usr, _off^_usr, Ql, Ql, Cud, Wwf, Gd^Vh, Gd, Cud, Ql, Ql, _off^_usr, _off^_usr, _off^_usr, _off^_usr, _off^_usr, _off^_usr, _off^_usr
_off^_usr, _off^_usr, _off^_usr, _off^_usr, _off^_usr, _off^_usr, _off^_usr, _off^_usr, _off^_usr, Ql, Ql, Hhd, Ql, Ql, _off^_usr, _off^_usr, _off^_usr, _off^_usr, _off^_usr, _off^_usr, _off^_usr, _off^_usr, _off^_usr
_off^_usr, _off^_usr, _off^_usr, _off^_usr, _off^_usr, _off^_usr, _off^_usr, _off^_usr, _off^_usr, _off^_usr, _off^_usr, Ql, _off^_usr, _off^_usr, _off^_usr, _off^_usr, _off^_usr, _off^_usr, _off^_usr, _off^_usr, _off^_usr, _off^_usr, _off^_usr
_off^_usr, _off^_usr, _off^_usr, _off^_usr, _off^_usr, _off^_usr, _off^_usr, _off^_usr, _off^_usr, _off^_usr, _off^_usr, _off^_usr, _off^_usr, _off^_usr, _off^_usr, _off^_usr, _off^_usr, _off^_usr, _off^_usr, _off^_usr, _off^_usr, _off^_usr, _off^_usr
