Xos, Xos, Rd, Xos, Xos, Xos, Rd, Xos, Xos, Xos, Rd, Xos, Xos, Xos, Rd, Xos, Xos, Xos, Rd, Xos, Xos, Xos, Rd, Xos, Xos, Xos, Rd, Xos, Rd, Xos, Rd, Xos, Rd, Xos, Rd, Xos, Rd, Xos, Xos
Xos, Xos, Rd, Xos, Wwf, Xos, Xos, Rd, Rd, Xos, Xos, Xos, Rd, Xos, Xos, Xos, Rd, Xos, Xos, Xos, Rd, Xos, Xos, Rd, Xos, Xos, Rd, Xos, Rd, Xos, Rd, Xos, Rd, Xos, Rd, Xos, Rd, Xos, Xos
Xos, Xos, Rd, Xos, Wwf, Wwf, Wwf, Xos, Xos, Rd, Rd, Xos, Xos, Xos, Rd, Xos, Xos, Xos, Rd, Xos, Xos, Xos, Rd, Xos, Rd, Xos, Xos, Xos, Rd, Xos, Rd, Xos, Rd, Xos, Rd, Xos, Rd, Xos, Xos
Xos, Xos, Rd, Xos, Wwf, Wwf, Wwf, Wwf, Wwf, Xos, Xos, Rd, Rd, Xos, Xos, Xos, Rd, Xos, Xos, Xos, Rd, Rd, Rd, Xos, Rd, Rd, Rd, Xos, Rd, Xos, Rd, Xos, Rd, Xos, Rd, Xos, Rd, Xos, Xos
Xos, Xos, Rd, Xos, Wwf, Wwf, Wwf, Wwf, Wwt, Wwt, Wwt, Xos, Xos, Rd, Rd, Xos, Xos, Xos, Rd, Xos, Rd, Rd, Rd, Xos, Rd, Rd, Rd, Xos, Rd, Xos, Rd, Xos, Rd, Xos, Rd, Xos, Rd, Xos, Xos
Xos, Xos, Rd, Xos, Wwf, Wwf, Wwf, Wwf, Wwt^Bsb/, Cme^Ewl, Wwt^Bsb\, Wwf, Wwf, Xos, Xos, Rd, Rd, Xos, Xos, Xos, Rd, Xos, Xos, Xos, Xos, Xos, Rd, Xos, Rd, Xos, Rd, Xos, Rd, Xos, Rd, Xos, Rd, Xos, Xos
Xos, Xos, Rd, Xos, Wwt, Wwt, Wwt^Bsb/, Wwf^Bsb/, Wwf, Wwt, Wwf, Wwf^Bsb\, Wwt^Bsb\, Wwt, Wwt, Xos, Xos, Rd, Rd, Xos, Rd, Rd, Rd, Xos, Rd, Rd, Rd, Xos, Rd, Xos, Rd, Xos, Rd, Xos, Rd, Xos, Xos, Xos, Xos
Xos, Xos, Rd, Xos, Wwt, Cm^Ewl, Wwt, Wwf, Wwf, Wwf, Wwf, Wwf, Wwt, Cme^Ewl, Wwt^Bsb\, Wwt, Wwt, Xos, Xos, Rd, Rd, Rd, Xos, Xos, Xos, Rd, Rd, Xos, Rd, Xos, Rd, Xos, Rd, Xos, Xos, Xos, Xos, Xos, Xos
Xos, Xos, Rd, Xos, Wwf, Wwt^Bsb|, Wwf, Wwf, Wwf, Wwf, Wwf, Wwf, Wwf, Wwt, Wwt, Cme^Ewl, Wwt, Wwf, Wwf, Xos, Xos, Xos, Wwf, Xos, Wwf, Xos, Xos, Xos, Rd, Xos, Rd, Xos, Xos, Xos, Rd, Rd, Rd, Xos, Xos
Xos, Xos, Rd, Xos, Wwf, Wwf^Bsb|, Wwf, Wwf, Wwf, Kd^Em, Wwf, Wwf, Gg, Ch, Ch, Wwt^Bsb|, Ch, Ch, Gg, Wwf, Wwf, Wwf, Xos, Wwf, Xos, Wwf, Wwf, Xos, Rd, Xos, Xos, Xos, Rd, Rd, Rd, Xos, Rd, Xos, Xos
Xos, Xos, Rd, Xos, Wwt, Wwt^Bsb|, Wwt, Wwf, Wwf, Wwf, Gg, Gll^Fp, Hh, Gg, Gg, 2 Kh^Vhc, Gg, Gg, Hh, Gg, Gg, Wwf, Wwf, Wwf, Wwf, Xos, Wwf, Xos, Xos, Xos, Rd, Rd, Rd, Rd, Rd, Rd, Rd, Xos, Xos
Xos, Xos, Rd, Xos, Wwt, Cm^Ewl, Wwt, Wwf, Gg, Hh, Hh, Gll^Fp, Gll^Fp, Gg, Gg, Ww, Gg, Gg, Gg, Hh, Hh, Gg, Wwf, Wwf, Wwf, Wwf, Xos, Wwf, Xos, Rd, Xos, Rd, Rd, Xos, Xos, Rd, Rd, Xos, Xos
Xos, Xos, Rd, Xos, Wwt, Wwt^Bsb|, Wwt, Ch, Gg, Gll^Fp, Hh, Xom^Em, Gg, Gg, Gg, Ww, Gg, Gll^Fp, Gg, Gg, Wwf, Wwf, Rp^Eb, Xos, Wwf, Wwf, Wwf, Wwf, Xos, Rd, Rd, Rd, Rd, Xos, Rd, Rd, Rd, Xos, Xos
Xos, Xos, Rd, Xos, Wwt, Cm^Ewl, Wwt^Bsb\, Ch, Gg, Gg, Gg, Gg, Gg^Uf, Gg^Vh, Hh, Ww, Gg, Gll^Fp, Wwf, Wwf, Rp^Eb, Rp^Eb, Xos, Xos, Wwf, Wwf, Xos, Wwf, Wwf, Xos, Xos, Rd, Rd, Rd, Rd, Rd, Rd, Xos, Xos
Xos, Xos, Rd, Xos, Wwf, Wwt, Ch, 3 Kh^Vhc, Ww, Gg, Gg, Gg^Vh, Gg, Gg, Hh, Xos, Wwf, Wwf, Rp^Eb, Rp^Eb, Xos, Xos, Xos, Xos, Wwf, Xos, Xos, Wwf, Aa, Aa, Aa, Xos, Xos, Rd, Rd, Xos, Rd, Xos, Xos
Xos, Xos, Rd, Xos, Wwf, Ch, Gg, Gg, Gg, Ww, Ww, Gll^Fp, Gll^Fp, Gg^Vh, Gg, Gg, Gg, Xos, Xos, Xos, Xos, Xos, Xos, Xos, Wwf, Wwf, Aa, Aa, Aa, Aa, Aa, Aa, Aa, Xos, Xos, Rd, Rd, Xos, Xos
Xos, Xos, Rd, Xos, Wwf, Gg, Gll^Fp, Gg, Hh, Gg, Gg, Xos, Gg, Gg, Gg, Gll^Fp, Gg, Wwf, Wwf, Xos, Xos, Xos, Xos, Xos, Aa, Aa, Aa, Aa, Ai, Ch, Ai, Aa, Aa, Aa, Wwf, Xos, Rd, Xos, Xos
Xos, Xos, Xos, Xos, Wwf, Gg, Gll^Fp, Gg, Gg, Hh, Wwf, Wwf, Gg, Hh, Gg, Gg, Gg, Xos, Gg, Ch, Gg, Xos, Xos, Xos, Aa, Aa, Ch, Ai, Wwf, Wwf, Wwf, Ai, Ch, Wwf, Dd, Xos, Rd, Xos, Xos
Xos, Xos, Wwf, Wwf, Wwf, Gg, Gll^Fp, Gg, Wwf, Wwf, Iwr^Eb, Xos, Wwf, Gg, Gg, Gg, Ww, Ce, Gg, Ww, Gg, Ce, Gg, Xos, Xu, Aa, Ai, Wwf, Wwf, Wwf, Wwf, Wwf, Ds, Dd, Dd, Xos, Rd, Xos, Xos
Xos, Xos, Wwf, Xos, Wwf, Gg, Wwf, Wwf, Iwr^Eb, Iwr^Eb, Xos, Xos, Wwf, Xos, Ce, Hh, Xuc^Em, Ww, Gg, Ww, Gll^Fp, Gg, Gg, Gg^Vo, Xu, Xu, Xu, Xu, Xu, Wwg^Ve, Wwf, Wwf, Ds, Dd, Dd, Xos, Rd, Xos, Xos
Xos, Wwf, Xos, Wwf, Wwf, Wwf, Iwr^Eb, Iwr^Eb, Xos, Xos, Xos, Xos, Ch, Gg, Gg, Hh, Gg, Gg, Ww, Ww, Gg, Gg, Gg, Gll^Fp, Xu, Iwr^Wm, Ch, Qxu^Bh/, Xu, Wwf, Wwf, Wwf, Ch, Dd, Dd, Xos, Rd, Xos, Xos
Xos, Wwf, Xos, Wwf, Wwf, Xos, Xos, Xos, Xos, Xos, Xos, Xos, Gg, Mm, Mm, Gg, Hh, Ket^Edp, Gg, Ww, Gll^Fp, Gg, Wwf, Gg, Xu, Iwr^Wm, Iwr^Wm, Xu, Ds, Wwf, Ds, Ds, Dd, Dd, Dd, Xos, Rd, Xos, Xos
Xos, Wwf, Wwf, Wwf, Wwf, Wwf, Wwf, Xos, Xos, Xos, Xos, Xos, Ce, Gll^Fp, Gll^Fp, Mm, Mm, Gg, Gg^Vh, Ww, Gg, Gll^Fp, Ko^Edpp, Wwf, Gg, Xu, Xu, Xu, Dd, Ch, Dd, Dd, Dd, Dd, Wwf, Xos, Rd, Xos, Xos
Xos, Xos, Wwf, Xos, Wwf, Wwf, Xos, Wwf, Wwf, Xos, Xos, Xos, Gll^Fp, Gg, Gll^Fp, Gg, Gg, Mm, Md^Xm, Wo, Gg^Uf, Gg, Gg, Wwf, Gg, Gg, Gg^Vo, Xu, Dd, Dd, Dd, Dd, Xos, Wwf, Wwf, Xos, Xos, Xos, Xos
Xos, Xos, Xos, Wwf, Wwf, Xos, Xos, Wwf, Ss, Ss, Ss, Xos, Gg^Vo, Gll^Fp, Gg, Gg, Gg, Gg, Gg^Uf, Xoi, Md^Xm, Gg, Gg, Gg, Gll^Fp, Gll^Fp, Gll^Fp, Xos, Xos, Dd, Wwf, Wwf, Xos, Xos, Wwf, Wwf, Wwf, Xos, Xos
Xos, Xos, Rd, Xos, Wwf, Wwf, Ss, Ss, Ss, Ss, Ss, Xu, Xu, Gg, Gg, Wwf, Ko^Edp, Gg, Gg, Wo, Gg^Vh, Mm, Mm, Gg, Gll^Fp, Gg, Ce, Xos, Xos, Xos, Xos, Wwf, Wwf, Wwf, Wwf, Xos, Wwf, Xos, Xos
Xos, Xos, Rd, Xos, Ss, Ss, Ss, Ss, Sm, Ch, Sm, Xu, Rp^Wm, Xu, Xu, Wwf, Wwf, Gll^Fp, Gll^Fp, Ww, Gg, Gg, Hh, Mm, Mm, Gll^Fp, Gg, Xos, Xos, Xos, Xos, Xos, Xos, Wwf, Wwf, Wwf, Xos, Wwf, Xos
Xos, Xos, Rd, Xos, Ss, Ss, Ch, Sm, Wwf, Wwf, Xu, Xu, Ch, Rp^Wm, Xu, Gg, Gg, Gg, Gg, Ww, Ww, Ket^Edpp, Gg, Gg, Gg, Mm, Ch, Xos, Xos, Xos, Xos, Xos, Iwr^Eb, Xos, Wwf, Wwf, Xos, Wwf, Xos
Xos, Xos, Rd, Xos, Ss, Ss, Sm, Wwf, Wwf, Wwf, Xu, Qxu^Bh/, Xu, Rp^Wm, Xu, Gll^Fp, Gg, Gg, Gll^Fp, Ww, Gg, Gg, Xuc^Es, Hh, Ce, Gg, Wwf, Xos, Xos, Xos, Iwr^Eb, Iwr^Eb, Wwf, Wwf, Wwf, Wwf, Wwf, Wwf, Xos
Xos, Xos, Rd, Xos, Ss, Ss, Sm, Wwf, Wwf, Wwt^Ve, Wwf, Xu, Uue, Xu, Xu, Gg^Vo, Gg, Gg, Gg, Ww, Gg, Ww, Ww, Hh, Gg, Xos, Wwf, Xos, Iwr^Eb, Iwr^Eb, Wwf, Wwf, Gll^Fp, Gg, Wwf, Xos, Wwf, Xos, Xos
Xos, Xos, Rd, Xos, Ss, Ss, Ch, Wwf, Wwf, Wwf, Wwf, Wwf, Ch, Uu, Uu, Xos, Xos, Ce, Gg, Ww, Gg, Ce, Gg, Gg, Gg, Gg, Gg, Xos, Wwf, Wwf, Gg, Gg, Gll^Fp, Gg, Wwf, Wwf, Xos, Xos, Xos
Xos, Xos, Rd, Xos, Wwf, Wwf, Uu, Uue, Uue, Wwf, Uue, Uue, Uu, Uu, Uu, Xos, Xos, Xos, Xos, Ch, Wwf, Xos, Gg, Gg, Gg, Hh, Gg, Wwf, Gg, Hh, Hh, Gg, Gll^Fp, Gg, Wwf, Xos, Rd, Xos, Xos
Xos, Xos, Rd, Xos, Xos, Uu, Uu, Uu, Uu, Ch, Uu, Uu, Uu, Uu, Wwf, Xos, Xos, Xos, Xos, Xos, Xos, Wwf, Gg, Gll^Fp, Gg, Gg, Gll^Fp, Xos, Ww, Gg, Gg, Gg, Gg, Gg, Wwf, Xos, Rd, Xos, Xos
Xos, Xos, Rd, Rd, Rd, Xos, Xos, Uu, Uu, Uu, Uu, Uu, Xos, Wwf, Wwf, Xos, Xos, Xos, Xos, Xos, Rp^Eb, Xos, Wwf, Gg, Hh, Gg^Vh, Gg, Gll^Fp, Gg, Ww, Ww, Gg, Ch, Ch, Wwf, Xos, Rd, Xos, Xos
Xos, Xos, Rd, Xos, Rd, Rd, Rd, Xos, Xos, Uu, Wwf, Wwf, Xos, Xos, Wwf, Xos, Xos, Xos, Rp^Eb, Rp^Eb, Wwf, Wwf, Gg, Xos, Hh, Gg, Gg^Uf, Gg^Vh, Gg, Gg, Gg, 4 Kh^Vhc, Wwt^Bsb\, Wwt, Wwt, Xos, Rd, Xos, Xos
Xos, Xos, Rd, Rd, Rd, Rd, Rd, Rd, Rd, Xos, Xos, Wwf, Wwf, Wwf, Wwf, Xos, Rp^Eb, Rp^Eb, Wwf, Wwf, Gg, Gll^Fp, Gg, Ww, Gg, Gg^Vh, Gg, Gg, Hh, Gg, Gg, Ch, Wwt, Cm^Ewf, Wwt, Xos, Rd, Xos, Xos
Xos, Xos, Rd, Rd, Xos, Xos, Rd, Rd, Xos, Rd, Xos, Wwf, Xos, Wwf, Wwf, Xos, Wwf, Wwf, Hh, Gg, Gg, Gll^Fp, Gg, Ww, Gg, Gg, Gll^Fp, Xom^Es, Hh, Gll^Fp, Gg, Ch, Wwt, Wwt^Bsb|, Wwt, Xos, Rd, Xos, Xos
Xos, Xos, Rd, Rd, Rd, Xos, Rd, Rd, Rd, Rd, Xos, Wwf, Wwf, Wwf, Wwf, Wwf, Wwf, Gg, Gg, Hh, Hh, Gg, Gg, Ww, Gg, Gg, Hh, Gll^Fp, Gg, Hh, Wwf, Wwf, Wwt, Cm^Ewf, Wwt, Xos, Rd, Xos, Xos
Xos, Xos, Rd, Rd, Rd, Rd, Rd, Rd, Xos, Xos, Rd, Xos, Wwf, Xos, Xos, Wwf, Xos, Wwf, Wwf, Gg, Gg, Gg, Ch, 1 Kh^Vhc, Ch, Gg, Gg, Gll^Fp, Wwf, Wwf, Wwf, Wwf, Wwf, Wwt^Bsb|, Wwf, Xos, Rd, Xos, Xos
Xos, Xos, Rd, Xos, Rd, Rd, Xos, Xos, Rd, Xos, Rd, Xos, Xos, Wwf, Wwf, Wwf, Wwf, Wwf, Xos, Wwf, Wwf, Ch, Wwt, Wwt^Bsb|, Wwt, Ch, Wwf, Wwf, Wwf, Kd^Es, Wwf, Wwf, Wwf, Wwf^Bsb|, Wwf, Xos, Rd, Xos, Xos
Xos, Xos, Xos, Rd, Xos, Xos, Rd, Xos, Rd, Xos, Rd, Xos, Rd, Xos, Xos, Xos, Xos, Xos, Rd, Xos, Xos, Wwf, Wwt, Cme^Ewf, Wwt^Bsb\, Wwt, Wwt, Wwf, Wwf, Wwf, Wwf, Wwf, Wwt, Wwt^Bsb|, Wwt, Xos, Rd, Xos, Xos
Xos, Xos, Xos, Xos, Rd, Xos, Rd, Xos, Rd, Xos, Rd, Xos, Rd, Rd, Rd, Xos, Rd, Rd, Rd, Rd, Rd, Xos, Xos, Wwt, Wwt, Cme^Ewf, Wwt^Bsb\, Wwf, Wwf, Wwf, Wwf, Wwf, Wwt^Bsb/, Cm^Ewf, Wwt, Xos, Rd, Xos, Xos
Xos, Xos, Rd, Xos, Rd, Xos, Rd, Xos, Rd, Xos, Rd, Xos, Rd, Rd, Xos, Xos, Xos, Rd, Rd, Xos, Xos, Rd, Rd, Xos, Xos, Wwt, Wwf, Wwf^Bsb\, Wwt^Bsb\, Wwt, Wwt^Bsb/, Wwf^Bsb/, Wwf, Wwt, Wwf, Xos, Rd, Xos, Xos
Xos, Xos, Rd, Xos, Rd, Xos, Rd, Xos, Rd, Xos, Rd, Xos, Rd, Xos, Rd, Xos, Rd, Xos, Rd, Xos, Rd, Xos, Xos, Rd, Rd, Xos, Xos, Wwf, Wwt, Cme^Ewf, Wwt, Wwf, Wwf, Wwf, Wwf, Xos, Rd, Xos, Xos
Xos, Xos, Rd, Xos, Rd, Xos, Rd, Xos, Rd, Xos, Rd, Xos, Rd, Rd, Rd, Xos, Rd, Rd, Rd, Xos, Xos, Xos, Rd, Xos, Xos, Rd, Rd, Xos, Xos, Wwt, Wwf, Wwf, Wwf, Wwf, Wwf, Xos, Rd, Xos, Xos
Xos, Xos, Rd, Xos, Rd, Xos, Rd, Xos, Rd, Xos, Rd, Xos, Xos, Rd, Rd, Xos, Rd, Rd, Xos, Xos, Rd, Xos, Xos, Xos, Rd, Xos, Xos, Rd, Rd, Xos, Xos, Wwf, Wwf, Wwf, Wwf, Xos, Rd, Xos, Xos
Xos, Xos, Rd, Xos, Rd, Xos, Rd, Xos, Rd, Xos, Rd, Xos, Rd, Xos, Xos, Xos, Xos, Xos, Rd, Xos, Xos, Xos, Rd, Xos, Xos, Xos, Rd, Xos, Xos, Rd, Rd, Xos, Xos, Wwf, Wwf, Xos, Rd, Xos, Xos
Xos, Xos, Rd, Xos, Rd, Xos, Rd, Xos, Rd, Xos, Rd, Xos, Rd, Xos, Xos, Rd, Rd, Xos, Xos, Xos, Rd, Xos, Xos, Xos, Rd, Xos, Xos, Xos, Rd, Xos, Xos, Rd, Rd, Xos, Xos, Xos, Rd, Xos, Xos
