border_size=1
usage=map

Xv, Gg, Gg, Gg, Gg, Gg, Gg, Gg, Gg, Gg, Gg, Gg, Gg, Gg, Gg, Gg, Gg, Gg, Gg, Gg, Gg, Gg, Gg, Gg, Gg, Gg, Gg, Gg, Gg, Gg, Gg, Gg, Gg, Gg, Gg, Gg, Gg, Gg, Gg, Gg, Gg, Gg, Gg, Gg, Gg, Gg, Gg, Gg, Gg, Gg, Gg, Gg, Gg, Gg, Gg, Gg, Gg, Gg, Gg, Gg, Gg, Gg, Gg, Gg, Gg, Gg, Gg, Gg, Gg, Gg, Gg, Gg, Gg, Gg, Gg, Gg, Xv
Xv, Gg, Gg, Gg, Gg, Gg, Gg, Gg, Gg, Gg, Gg, Gg^Bw|, Gg, Gg, Gg, Gg, Gg, Gg, Gg, Gg, Gg, Gg, Gg, Gg, Gg, Gg, Gg, Gg, Gg, Gg, Gg, Gg, Gg, Gg, Gg, Gg, Gg, Gg, Gg, Gg, Gg, Gg, Gg, Gg, Gg, Gg, Gg, Gg, Gg, Gg, Gg, Gg, Gg, Gg, Gg, Gg, Gg, Gg, Gg, Gg, Gg, Gg, Gg, Gg, Gg, Gg^Bw|, Gg, Gg, Gg, Gg, Gg, Gg, Gg, Gg, Gg, Gg, Xv
Xv, Gg, Gg, Gg, Gg, Gg, Gg, Gg, Gg, Gg, Gg, Gg^Bw|, Gg, Gg, Gg, Gg, Gg, Gg, Gg, Gg, Gg, Gg, Gg, Gg, Gg, Gg, Gg, Gg, Gg, Gg, Gg, Gg, Gg, Gg, Gg, Gg, Gg, Gg, Gg, Gg, Gg, Gg, Gg, Gg, Gg, Gg, Gg, Gg, Gg, Gg, Gg, Gg, Gg, Gg, Gg, Gg, Gg, Gg, Gg, Gg, Gg, Gg, Gg, Gg, Gg, Gg^Bw|, Gg, Gg, Gg, Gg, Gg, Gg, Gg, Gg, Gg, Gg, Xv
Xv, Gg, Gg, Gg, Gg, Gg, Gg, Gg, Gg, Gg, Gg, Gg^Bw|, Gg, Gg, Gg, Gg, Gg, Gg, Gg, Gg, Gg, Gg, Gg, Gg, Gg, Gg, Gg, Gg, Gg, Gg, Gg, Gg, Gg, Gg, Gg, Gg, Gg, Gg, Ms^Vhha, Gg, Gg, Gg, Gg, Gg, Gg, Gg, Gg, Gg, Gg, Gg, Gg, Gg, Gg, Gg, Gg, Gg, Gg, Gg, Gg, Gg, Gg, Gg, Gg, Gg, Gg, Gg^Bw|, Gg, Gg, Gg, Gg, Gg, Gg, Gg, Gg, Gg, Gg, Xv
Xv, Gg, Gg, Gg, Gg, Gg, Gg, Gg, Gg, Gg, Gg, Gg^Bw|, Gg, Gg, Gg, Gg, Gg, Gg, Gg, Gg, Gg, Gg, Gg, Gg, Gg, Gg, Gg, Gg, Gg, Gg, Gg, Gg, Gg, Gg, Gg, Gg, Gg, Gg, Xu, Gg, Gg, Gg, Gg, Gg, Gg, Gg, Gg, Gg, Gg, Gg, Gg, Gg, Gg, Gg, Gg, Gg, Gg, Gg, Gg, Gg, Gg, Gg, Gg, Gg, Gg, Gg^Bw|, Gg, Gg, Gg, Gg, Gg, Gg, Gg, Gg, Gg, Gg, Xv
Xv, Gg, Gg, Gg, Gg, Gg, Gg, Gg, Gg, Gg, Gg, Gg^Bw|, Gg, Gg, Gg, Gg, Gg, Gg, Gg, Gg, Gg, Gg, Gg, Gg, Gg, Gg, Gg, Gg, Gg, Gg, Gg, Gg, Gg, Gg, Gg, Gg, Gg, Gg, Xu, Gg, Gg, Gg, Gg, Gg, Gg, Gg, Gg, Gg, Gg, Gg, Gg, Gg, Gg, Gg, Gg, Gg, Gg, Gg, Gg, Gg, Gg, Gg, Gg, Gg, Gg, Gg^Bw|, Gg, Gg, Gg, Gg, Gg, Gg, Gg, Gg, Gg, Gg, Xv
Xv, Gg, Chr, Gg, Gg, Gg, Gg, Gg, Gg, Gg, Gg, Gg^Bw|, Gg, Gg, Gg, Gg, Gg, Gg, Gg, Gg, Gg, Gg, Gg, Gg, Gg, Gg, Gg, Gg, Gg, Gg, Gg, Gg, Gg, Gg, Gg, Gg, Gg, Ms, Xu, Ms, Gg, Gg, Gg, Gg, Gg, Gg, Gg, Gg, Gg, Gg, Gg, Gg, Gg, Gg, Gg, Gg, Gg, Gg, Gg, Gg, Gg, Gg, Gg, Gg, Gg, Gg^Bw|, Gg, Gg, Gg, Gg, Gg, Gg, Gg, Gg, Chr, Gg, Xv
Xv, Chr, 3 Khr, Chr, Gg, Gg, Gg, Gg, Gg, Gg, Gg, Gg^Bw|, Gg, Gg, Gg, Gg, Gg, Gg, Gg, Gg, Gg, Gg, Gg, Gg, Gg, Gg, Gg, Gg, Gg, Gg, Gg, Gg, Gg, Gg, Gg, Gg, Mm, Xu, Uu, Xu, Mm, Gg, Gg, Gg, Gg, Gg, Gg, Gg, Gg, Gg, Gg, Gg, Gg, Gg, Gg, Gg, Gg, Gg, Gg, Gg, Gg, Gg, Gg, Gg, Gg, Gg^Bw|, Gg, Gg, Gg, Gg, Gg, Gg, Gg, Chr, 1 Khr, Chr, Xv
Xv, Xu, Xu, Chr, Chr, Gg, Rp^Vhc, Gg, Gg, Gg, Gg, Gg^Bw|, Gg, Gg, Gg, Gg, Gg, Gg, Gg, Gg, Gg, Gg, Gg, Gg, Gg, Gg, Gg, Gg, Gg, Gg, Gg, Gg, Gg, Gg, Gg, Gg, Xu, Xu, Uu^Vud, Xu, Xu, Gg, Gg, Gg, Gg, Gg, Gg, Gg, Gg, Gg, Gg, Gg, Gg, Gg, Gg, Gg, Gg, Gg, Gg, Gg, Gg, Gg, Gg, Gg, Gg, Gg^Bw|, Gg, Gg, Gg, Gg, Rp^Vhc, Gg, Chr, Chr, Xu, Xu, Xv
Xv, Xu, Xu, Xu, Xu, Xu, Xu, Xu, Xu, Xu, Xu, Gg^Bw|, Gg, Gg, Gg, Gg, Gg, Gg, Gg, Gg, Gg, Gg, Ms, Gg, Gg, Gg, Gg, Gg, Gg, Gg, Gg, Gg, Gg, Gg, Gg, Gg, Xu, Uu, Uu, Uu, Xu, Gg, Gg, Gg, Gg, Gg, Gg, Gg, Gg, Gg, Gg, Gg, Gg, Gg, Ms, Gg, Gg, Gg, Gg, Gg, Gg, Gg, Gg, Gg, Gg, Gg^Bw|, Xu, Xu, Xu, Xu, Xu, Xu, Xu, Xu, Xu, Xu, Xv
Xv, Gg, Gg, Gg, Gg, Gg, Gg, Gg, Gg, Gg, Gg, Gg^Bw|, Gg, Gg, Gg, Gg, Gg, Gg, Gg, Gg, Hh, Ha, Xu, Ha^Vhha, Hh, Gg, Gg, Gg, Gg, Gg, Gg, Gg, Gg, Gg, Gg, Mm^Vhh, Xu, Uu, Uu, Uu, Xu, Mm^Vhh, Gg, Gg, Gg, Gg, Gg, Gg, Gg, Gg, Gg, Gg, Hh, Ha^Vhha, Xu, Ha, Hh, Gg, Gg, Gg, Gg, Gg, Gg, Gg, Gg, Gg^Bw|, Gg, Gg, Gg, Gg, Gg, Gg, Gg, Gg, Gg, Gg, Xv
Xv, Gg, Gg, Gg, Gg, Gg, Gg, Gg, Gg, Gg, Gg, Gg^Bw|, Gg, Gg, Gg, Gg, Gg, Gg, Gg^Vh, Hh^Fp, Xu, Xu, Uu, Xu, Xu, Gg, Gg, Gg, Gg, Gg, Gg, Gg, Gg, Gg, Gg, Xu, Uu, Uu, Uu, Uu, Uu, Xu, Gg, Gg, Gg, Gg, Gg, Gg, Gg, Gg, Gg, Gg, Xu, Xu, Uu, Xu, Xu, Hh^Fp, Gg^Vh, Gg, Gg, Gg, Gg, Gg, Gg, Gg^Bw|, Gg, Gg, Gg, Gg, Gg, Gg, Gg, Gg, Gg, Gg, Xv
Xv, Gg, Ch, Gg, Gg, Gg, Gg, Gg, Gg, Gg, Gg, Gg^Bw|, Gg, Gg, Gg, Gg, Gg, Gg, Hh^Fp, Xu, Ur, Uu, Xu, Uu, Uu, Hh, Gg, Gg, Gg, Gg, Gg, Gg, Gg, Gg, Hh, Xu, Uu^Vu, Uu, 9 Uu, Uu, Uu^Vu, Xu, Hh, Gg, Gg, Gg, Gg, Gg, Gg, Gg, Gg, Hh, Uu, Uu, Xu, Uu, Ur, Xu, Hh^Fp, Gg, Gg, Gg, Gg, Gg, Gg, Gg^Bw|, Gg, Gg, Gg, Gg, Gg, Gg, Gg, Gg, Ch, Gg, Xv
Xv, Ch, 2 Kh, Ch, Gg, Gg, Gg, Gg, Gg, Gg, Gg, Gg^Bw|, Gg, Gg, Gg, Gg, Gg, Gg, Xu, Xu, Uu^Vu, Xu, Uu, Xu, Xu, Xu, Gg^Vl, Gg, Gg, Gg, Gg, Gg, Gg, Gg, Xu, Xu, Uu, 7 Uu, Xu, 8 Uu, Uu, Xu, Xu, Gg, Gg, Gg, Gg, Gg, Gg, Gg, Gg^Vl, Xu, Xu, Xu, Uu, Xu, Uu^Vu, Xu, Xu, Gg, Gg, Gg, Gg, Gg, Gg, Gg^Bw|, Gg, Gg, Gg, Gg, Gg, Gg, Gg, Ch, 4 Kh, Ch, Xv
Xv, Xu, Xu, Ch, Ch, Gg, Rp^Vhc, Gg, Gg, Gg, Gg, Gg^Bw|, Gg, Gg, Gg, Gg, Gg, Hh^Fp, Xu, Ur, Xu, Xu, Uu, Xu, Xu, Xu, Xu, Wwf, Wwf, Wwf, Wwf, Wwf, Wwf, Wwf, Xu, Ur, Xu, Xu, Xu, Xu, Xu, Ur, Xu, Wwf, Wwf, Wwf, Wwf, Wwf, Wwf, Wwf, Xu, Xu, Xu, Xu, Uu, Xu, Xu, Ur, Xu, Hh^Fp, Gg, Gg, Gg, Gg, Gg, Gg^Bw|, Gg, Gg, Gg, Gg, Rp^Vhc, Gg, Ch, Ch, Xu, Xu, Xv
Xv, Xu, Xu, Xu, Xu, Xu, Xu, Xu, Xu, Xu, Xu, Gg^Bw|, Gg, Gg, Gg, Gg, Hh^Fp, Xu, Ur, Uu, Xu, Uu^Vud, Uu, Xu, Uu, Uu, Xu, Xu, Ww, Ww, Ww, Ww, Ww^Vm, Ww, Xu, Ur, Uu, Uu, Xu, Uu, Uu, Ur, Xu, Ww, Ww^Vm, Ww, Ww, Ww, Ww, Xu, Xu, Uu, Uu, Xu, Uu, Uu^Vud, Xu, Uu, Ur, Xu, Hh^Fp, Gg, Gg, Gg, Gg, Gg^Bw|, Xu, Xu, Xu, Xu, Xu, Xu, Xu, Xu, Xu, Xu, Xv
Xv, Gg, Gg, Gg, Gg, Gg, Gg, Gg, Gg, Gg, Gg, Gg^Bw|, Gg, Gg, Gg, Gg^Vh, Xu, Xu, Uu, Xu, Uu, Xu, Uu, Xu, Uu, Uu, Uu, Ww, Xu, Xu, Xu, Wo, Wo, Xu, Uu, Xu, Uu^Vud, Xu, Xu, Xu, Uu^Vud, Xu, Uu, Xu, Wo, Wo, Xu, Xu, Xu, Ww, Uu, Uu, Uu, Xu, Uu, Xu, Uu, Xu, Uu, Xu, Xu, Gg^Vh, Gg, Gg, Gg, Gg^Bw|, Gg, Gg, Gg, Gg, Gg, Gg, Gg, Gg, Gg, Gg, Xv
Xv, Gg, Gg, Gg, Gg, Gg, Gg, Gg, Gg, Gg, Gg, Gg^Bw|, Gs^Fp, Gg, Hh^Fp, Hh^Fp, Xu, Ur, Xu, Xu, Uu, Xu, Uu, Xu, Uu, Uu, Uu, Wwf, Uu, Uu, Uu, Xu, Xu, Xu, Uu, Xu, Xu, Ur, Uu, Ur, Xu, Xu, Uu, Xu, Xu, Xu, Uu, Uu, Uu, Wwf, Uu, Uu, Uu, Xu, Uu, Xu, Uu, Xu, Xu, Ur, Xu, Hh^Fp, Hh^Fp, Gg, Gs^Fp, Gg^Bw|, Gg, Gg, Gg, Gg, Gg, Gg, Gg, Gg, Gg, Gg, Xv
Xv, Gg, Ch, Gg, Gg, Gg, Gg, Gg, Gg, Gg, Gg, Gg^Bw|, Xu, Gs^Fp, Xu, Xu, Uu^Vu, Uu, Xu, Uu, Uu, Uu, Uu, Uu, Uu, Uu, Uu, Wwf, Uu, Uu, Uu, Uu, Uu, Uu, Uu, Xu, Uh, Uu, Xu, Uu, Uh, Xu, Uu, Uu, Uu, Uu, Uu, Uu, Uu, Wwf, Uu, Uu, Uu, Uu, Uu, Uu, Uu, Uu, Xu, Uu, Uu^Vu, Xu, Xu, Gs^Fp, Xu, Gg^Bw|, Gg, Gg, Gg, Gg, Gg, Gg, Gg, Gg, Ch, Gg, Xv
Xv, Ch, 6 Kh, Ch, Gg, Gg, Gg, Gg, Gg, Gg, Gg, Gg^Bw|, Xu, Xu, Uu, Ur, Xu, Xu, Xu, Uu, Uu, Uu, Uu, Uu, Uu, Uu, Uu, Wwf, Uu, Uu, Uu, Uu, Uu, Uu, Uh, Uh, Xu, Xu, Xu, Xu, Xu, Uh, Uh, Uu, Uu, Uu, Uu, Uu, Uu, Wwf, Uu, Uu, Uu, Uu, Uu, Uu, Uu, Uu, Xu, Xu, Xu, Ur, Uu, Xu, Xu, Gg^Bw|, Gg, Gg, Gg, Gg, Gg, Gg, Gg, Ch, 5 Kh, Ch, Xv
Xv, Xu, Xu, Ch, Ch, Gg, Rp^Vhc, Gg, Gg, Gg, Gg, Gg^Bw|, Xu, Uu^Uf, Uu^Uf, Uu, Uu, Uu, Uu, Uu^Vu, Uu, Uu, Uu, Uu, Ss, Ss, Ss, Ss, Ss, Ss^Vhs, Ss, Uu, Uh, Uh, Uu^Vu, Xu, Xu, Xu, Xu, Xu, Xu, Xu, Uu^Vu, Uh, Uh, Uu, Ss, Ss^Vhs, Ss, Ss, Ss, Ss, Ss, Uu, Uu, Uu, Uu, Uu^Vu, Uu, Uu, Uu, Uu, Uu^Uf, Uu^Uf, Xu, Gg^Bw|, Gg, Gg, Gg, Gg, Rp^Vhc, Gg, Ch, Ch, Xu, Xu, Xv
Xv, Xu, Xu, Xu, Xu, Xu, Xu, Xu, Xu, Xu, Xu, Xu, Xu, Xu, Xu, Xu, Xu, Xu, Xu, Xu, Xu, Xu, Xu, Xu, Xu, Xu, Xu, Xu, Xu, Xu, Xu, Xu, Xu, Xu, Xu, Xu, Xu, Xu, Xu, Xu, Xu, Xu, Xu, Xu, Xu, Xu, Xu, Xu, Xu, Xu, Xu, Xu, Xu, Xu, Xu, Xu, Xu, Xu, Xu, Xu, Xu, Xu, Xu, Xu, Xu, Xu, Xu, Xu, Xu, Xu, Xu, Xu, Xu, Xu, Xu, Xu, Xv
Xu, Xu, Xu, Xu, Xu, Xu, Xu, Xu, Xu, Xu, Xu, Xu, Xu, Xu, Xu, Xu, Xu, Xu, Xu, Xu, Xu, Xu, Xu, Xu, Xu, Xu, Xu, Xu, Xu, Xu, Xu, Xu, Xu, Xu, Xu, Xu, Xu, Xu, Xu, Xu, Xu, Xu, Xu, Xu, Xu, Xu, Xu, Xu, Xu, Xu, Xu, Xu, Xu, Xu, Xu, Xu, Xu, Xu, Xu, Xu, Xu, Xu, Xu, Xu, Xu, Xu, Xu, Xu, Xu, Xu, Xu, Xu, Xu, Xu, Xu, Xu, Xu
