border_size=1
usage=map

Gg, Gg, Gg, Gg, Gg, Gg, Gg, Gg, Gg, Aa, Aa, Aa, Aa, Aa, Xu, Dd, Dd, Dd, Dd, Dd, Gg, Gg, Gg, Gg, Gg, Gg, Gg, Gg, Gg
Gg, Gg, Ch, Gg, 1 Kh, Gg, Ch, Gg, Gg, Aa, Aa, Aa, Aa, Aa, Xu, Dd, Dd, Dd, Dd, Dd, Gg, Gg, Ch, Gg, 2 Kh, Gg, Ch, Gg, Gg
Xu, Wwf, Xu, Ch, Xu, Ch, Xu, Gg, Gg, Aa, Xu, Aa^Vea, Xu, Aa, Xu, Dd, Xu, Dd^Vda, Xu, Dd, Gg, Gg, Xu, Ch, Xu, Ch, Xu, Wwf, Xu
Xu, Ww, Xu, Xu, Uu, Xu, Xu, Gg, Gg, Gg, Gg, Xu, Ha, Ha, Hh, Hd, Hd, Xu, Gg, Gg, Gg, Gg, Xu, Xu, Uu, Xu, Xu, Ww, Xu
Xu, Ww, Xu, Uu, Uu^Vu, Uu, Xu, Gg^Vh, Gg, Gg, Gg, Gg, Ha, Hh, Mm^Vhh, Hh, Hd, Gg, Gg, Gg, Gg, Gg^Vh, Xu, Uu, Uu^Vud, Uu, Xu, Ww, Xu
Xu, Ww, Xu, Uu, Uu, Uu, Uu, Xu, Gg, Gg, Gg, Gg, Gg, Xu, Xu, Xu, Gg, Gg, Gg, Gg, Gg, Xu, Uu, Uu, Uu, Uu, Xu, Ww, Xu
Xu, Ww, Ww, Xu, Xu, Xu, Uu, Xu, Gg, Gg, Gg^Vc, Gs^Fms, Gs^Fms, Gs^Fms, Gs^Fms, Gs^Fms, Gs^Fms, Gs^Fms, Gg^Vc, Gg, Gg, Xu, Uu, Xu, Xu, Xu, Ww, Ww, Xu
Xu, Ww, Ww^Vm, Ww, Ss, Uu, Xu, Xu, Wwf, Wwf, Wwf, Wwf, Wwf, Gs^Fms, Gs^Fms, Gs^Fms, Wwf, Wwf, Wwf, Wwf, Wwf, Xu, Xu, Uu, Ss, Ww, Ww^Vm, Ww, Xu
Xu, Wo, Wo, Wo, Xu, Ss, Ss, Ss, Ss, Ww, Xu, Xu, Xu, Xu, Xu, Xu, Xu, Xu, Xu, Ww, Ss, Ss, Ss, Ss, Xu, Wo, Wo, Wo, Xu
Xu, Xu, Xu, Xu, Xu, Xu, Xu, Xu, Xu, Xu, Xu, Xu, Xu, Xu, Xu, Xu, Xu, Xu, Xu, Xu, Xu, Xu, Xu, Xu, Xu, Xu, Xu, Xu, Xu
Xu, Xu, Xu, Xu, Xu, Xu, Xu, Xu, Xu, Xu, Xu, Xu, Xu, Xu, Xu, Xu, Xu, Xu, Xu, Xu, Xu, Xu, Xu, Xu, Xu, Xu, Xu, Xu, Xu
