border_size=1
usage=map

Qxua, Qxua, Qxua, Qxua, Qxua, Qxua, Qxua, Qxua, Qxua, Qxua, Qxua, Qxua, Qxua, Qxua, Qxua, Qxua, Qxua, Qxua, Qxua, Qxua, Qxua, Qxua, Qxua, Qxua, Qxua, Qxua, Qxua, Qxua, Qxua, Qxua, Qxua, Qxua
Qxua, Qxua, Qxua, Qxua, Qxua, Qxua, Qxua, Qxua, Qxua, Qxua, Qxua, Qxua, Qxua, Qxua, Qxua, Qxua, Qxua, Qxua, Qxua, Qxua, Qxua, Qxua, Qxua, Qxua, Qxua, Qxua, Qxua, Qxua, Qxua, Qxua, Qxua, Qxua
Qxua, Qxua, Qxua, Qxua, Qxua, Qxua, Qxua, Qxua, Qxua, Qxua, Qxua, Qxua, Qxua, Qxua, Qxua, Qxua, Qxua, Qxua, Qxua, Qxua, Qxua, Qxua, Qxua, Qxua, Qxua, Qxua, Rrc, Qxua, Qxua, Qxua, Qxua, Qxua
Qxua, Qxua, Qxua, Qxua, Qxua, Qxua, Qxua, Qxua, Qxua, Qxua, Qxua, Qxua, Qxua, Qxua, Qxua, Qxua, Gg^Vwm, Qxua, Qxua, Qxua, Gg, Gg, Gg, Qxua, Rrc^Vhc, Rrc, Rrc, Rrc, Rrc, Qxua, Qxua, Qxua
Qxua, Qxua, Qxua, Qxua, Qxua, Qxua, Qxua, Qxua, Qxua, Qxua, Qxua, Qxua, Gg, Qxua, Gg, Gg, Gg, Gg, Gg, Gg, Gg, Gg, Gg, Gg, Rrc, Rrc, 2 Kv, Cv, Rrc, Qxua, Qxua, Qxua
Qxua, Qxua, Qxua, Qxua, Qxua, Qxua, Qxua, Qxua, Qxua, Qxua, Gg, Gg, Gg^Fds, Gg^Fds, Gg, Gg, Hh, Gg, Gg, Gg, Mm, Mm^Xm, Wwf, Gg, Gg, Cv, Cv, Cv, Gg, Qxua, Qxua, Qxua
Qxua, Qxua, Qxua, Qxua, Qxua, Qxua, Gg, Gg, Gg, Qxua, Gg, Gg^Vh, Gg^Fds, Gg^Fds, Gg, Gg, Gg, Hh, Gg, Gg, Mm, Mm, Gg, Wwt, Wwt^Bs/, Ur, Gg, Gg, Qxua, Qxua, Qxua, Qxua
Qxua, Qxua, Qxua, Qxua, Gg, Gg, Wwt, Wwt, Wwt, Gg, Gg, Gg, Gg, Gg, Gg, Gg, Gg, Hh, Qxua, Xos, Xos, Gg, Ur, Ur, Gg^Ftr, Wwt, Wwf, Qxua, Qxua, Qxua, Qxua, Qxua
Qxua, Qxua, Qxua, Qxua, Wwf, Wwt, Wwf, Gg, Ch, Wwt, Wwt, Gg, Gg, Gg, Xos, Xos, Xos, Qxua, Gg, Gg, Ur, Qxua^Bs/, Gg, Gg^Vht, Gg^Ftr, Wwt, Wwt, Qxua, Qxua, Qxua, Qxua, Qxua
Qxua, Qxua, Qxua, Qxua, Wwt, Wwt, Qxua, Qxua^Bh|, Qxua, Qxua, Wwt, Xos, Xos, Gg, Gg, Qxua, Qxua, Xos, Ur, Ur, Wwf, Xos, Gg, Gg, Gg^Ftr, Gg^Ftr, Gg^Ftr, Wwt, Wwt, Qxua, Qxua, Qxua
Qxua, Qxua, Gg, Wwt, Gg, Qxua, Qxua, Qxua^Bh|, Qxua, Qxua, Wwt, Qxua, Qxua, Xos, Xos, Gg, Ur, Qxua^Bs/, Qxua, Wwf, Wwt, Qxua, Xos, Gg, Gg, Gg^Ftr, Xos, Gg, Wwt, Gg, Qxua, Qxua
Qxua, Qxua, Gg, Wwt, Gg, Xos, Gg^Ftr, Gg, Gg, Xos, Qxua, Wwt, Wwf, Qxua, Qxua^Bs/, Ur, Gg, Xos, Xos, Qxua, Qxua, Wwt, Qxua, Qxua, Qxua^Bh|, Qxua, Qxua, Gg, Wwt, Gg, Qxua, Qxua
Qxua, Qxua, Qxua, Wwt, Wwt, Gg^Ftr, Gg^Ftr, Gg^Ftr, Gg, Gg, Xos, Wwf, Ur, Ur, Xos, Qxua, Qxua, Gg, Gg, Xos, Xos, Wwt, Qxua, Qxua, Qxua^Bh|, Qxua, Wwt, Wwt, Qxua, Qxua, Qxua, Qxua
Qxua, Qxua, Qxua, Qxua, Qxua, Wwt, Wwt, Gg^Ftr, Gg^Vht, Gg, Qxua^Bs/, Ur, Gg, Gg, Qxua, Xos, Xos, Xos, Gg, Gg, Gg, Wwt, Wwt, Ch, Gg, Wwf, Wwt, Wwf, Qxua, Qxua, Qxua, Qxua
Qxua, Qxua, Qxua, Qxua, Qxua, Wwf, Wwt, Gg^Ftr, Ur, Ur, Gg, Xos, Xos, Qxua, Hh, Gg, Gg, Gg, Gg, Gg, Gg, Gg, Gg, Wwt, Wwt, Wwt, Gg, Gg, Qxua, Qxua, Qxua, Qxua
Qxua, Qxua, Qxua, Qxua, Gg, Gg, Ur, Wwt^Bs/, Wwt, Gg, Mm, Mm, Gg, Gg, Hh, Gg, Gg, Gg, Gg^Fds, Gg^Fds, Gg^Vh, Gg, Qxua, Gg, Gg, Gg, Qxua, Qxua, Qxua, Qxua, Qxua, Qxua
Qxua, Qxua, Qxua, Gg, Cv, Cv, Cv, Gg, Gg, Wwf, Mm^Xm, Mm, Gg, Gg, Gg, Hh, Gg, Gg, Gg^Fds, Gg^Fds, Gg, Gg, Qxua, Qxua, Qxua, Qxua, Qxua, Qxua, Qxua, Qxua, Qxua, Qxua
Qxua, Qxua, Qxua, Rrc, Cv, 1 Kv, Rrc, Rrc, Gg, Gg, Gg, Gg, Gg, Gg, Gg, Gg, Gg, Gg, Qxua, Gg, Qxua, Qxua, Qxua, Qxua, Qxua, Qxua, Qxua, Qxua, Qxua, Qxua, Qxua, Qxua
Qxua, Qxua, Qxua, Rrc, Rrc, Rrc, Rrc, Rrc^Vhc, Qxua, Gg, Gg, Gg, Qxua, Qxua, Qxua, Gg^Vwm, Qxua, Qxua, Qxua, Qxua, Qxua, Qxua, Qxua, Qxua, Qxua, Qxua, Qxua, Qxua, Qxua, Qxua, Qxua, Qxua
Qxua, Qxua, Qxua, Qxua, Qxua, Rrc, Qxua, Qxua, Qxua, Qxua, Qxua, Qxua, Qxua, Qxua, Qxua, Qxua, Qxua, Qxua, Qxua, Qxua, Qxua, Qxua, Qxua, Qxua, Qxua, Qxua, Qxua, Qxua, Qxua, Qxua, Qxua, Qxua
Qxua, Qxua, Qxua, Qxua, Qxua, Qxua, Qxua, Qxua, Qxua, Qxua, Qxua, Qxua, Qxua, Qxua, Qxua, Qxua, Qxua, Qxua, Qxua, Qxua, Qxua, Qxua, Qxua, Qxua, Qxua, Qxua, Qxua, Qxua, Qxua, Qxua, Qxua, Qxua
Qxua, Qxua, Qxua, Qxua, Qxua, Qxua, Qxua, Qxua, Qxua, Qxua, Qxua, Qxua, Qxua, Qxua, Qxua, Qxua, Qxua, Qxua, Qxua, Qxua, Qxua, Qxua, Qxua, Qxua, Qxua, Qxua, Qxua, Qxua, Qxua, Qxua, Qxua, Qxua
